bahman	ㅂㅏㅎㅡㅁㅏㄴ
hanne	ㅎㅏㄴㄴㅔ
ustinov	ㅇㅜㅅㅡㅌㅣㄴㅗㅍㅡ
nieve	ㄴㅣㅇㅔㅂㅔ
marsden	ㅁㅏㄹㅅㅡㄷㅔㄴ
vecsey	ㅂㅔㄱㅅㅣ
sydney	ㅅㅣㄷㅡㄴㅣ
daria	ㄷㅏㄹㅣㅇㅏ
mussolini	ㅁㅜㅅㅗㄹㄹㅣㄴㅣ
thiago	ㅌㅣㅇㅏㄱㅜ
modibo	ㅁㅗㄷㅣㅂㅗ
toselli	ㅌㅗㅅㅔㄹㄹㅣ
christiansen	ㅋㅡㄹㅣㅅㅡㅌㅣㅇㅏㄴㅅㅔㄴ
clive	ㅋㅡㄹㄹㅏㅇㅣㅂㅡ
hitomi	ㅎㅣㅌㅗㅁㅣ
cannavaro	ㅋㅏㄴㄴㅏㅂㅏㄹㅗ
dell	ㄷㅔㄹ
soul	ㅅㅗㄹ
duverger	ㄷㅟㅂㅔㄹㅡㅈㅔ
meyers	ㅁㅏㅇㅣㅇㅓㅅㅡ
sorvino	ㅅㅗㄹㅡㅂㅣㄴㅗ
trainor	ㅌㅡㄹㅔㅇㅣㄴㅓ
therese	ㅌㅔㄹㅔㅅㅔ
french	ㅍㅡㄹㅔㄴㅊㅣ
ziani	ㅈㅣㅇㅏㄴㅣ
marano	ㅁㅏㄹㅏㄴㅗ
dave	ㄷㅔㅇㅣㅂㅡ
marx	ㅁㅏㄹㅡㅋㅡㅅㅡ
rees	ㄹㅣㅅㅡ
frances	ㅍㅡㄹㅐㄴㅅㅣㅅㅡ
katja	ㅋㅏㅌㅑ
claudio	ㅋㅡㄹㄹㅏㅇㅜㄷㅣㅇㅗ
hutchinson	ㅎㅓㅊㅣㄴㅅㅡㄴ
dayan	ㄷㅏㅇㅑㄴ
cuthbert	ㅋㅓㅅㅡㅂㅓㅌㅡ
hastings	ㅎㅔㅇㅣㅅㅡㅌㅣㅇㅅㅡ
mackenzie	ㅁㅐㅋㅔㄴㅈㅣ
wyler	ㅇㅘㅇㅣㄹㄹㅓ
whitehead	ㅎㅘㅇㅣㅌㅡㅎㅔㄷㅡ
palin	ㅍㅔㅇㅣㄹㄹㅣㄴ
bell	ㅂㅔㄹ
novello	ㄴㅗㅂㅔㄹㄹㅗ
arden	ㅇㅏㄷㅡㄴ
geoffrey	ㅈㅔㅍㅡㄹㅣ
ness	ㄴㅔㅅㅡ
palacio	ㅍㅏㄹㄹㅏㅅㅣㅇㅗ
muneharu	ㅁㅜㄴㅔㅎㅏㄹㅜ
billingsley	ㅂㅣㄹㄹㅣㅇㅅㅡㄹㄹㅣ
pastrana	ㅍㅏㅅㅡㅌㅡㄹㅏㄴㅏ
nikolaos	ㄴㅣㅋㅗㄹㄹㅏㅇㅗㅅㅡ
tracey	ㅌㅡㄹㅔㅇㅣㅅㅣ
mauro	ㅁㅏㅇㅜㄹㅗ
chiara	ㅋㅣㅇㅏㄹㅏ
shinawatra	ㅊㅣㄴㄴㅏㅇㅘㅅ
maxi	ㅁㅏㄱㅅㅣ
van	ㅍㅏㄴ
giovanni	ㅈㅗㅂㅏㄴㄴㅣ
sugar	ㅅㅠㄱㅓ
pier	ㅍㅣㅇㅔㄹㅡ
meade	ㅁㅣㄷㅡ
fonseca	ㅍㅗㄴㅅㅔㅋㅏ
duda	ㄷㅜㄷㅏ
guilherme	ㄱㅣㄹㄹㅔㄹㅡㅁㅣ
bergman	ㅂㅓㄱㅡㅁㅓㄴ
gonzalo	ㄱㅗㄴㅅㅏㄹㄹㅗ
aleksander	ㅇㅏㄹㄹㅔㄱㅅㅏㄴㄷㅔㄹㅡ
lester	ㄹㅔㅅㅡㅌㅓ
foxx	ㅍㅗㄱㅅㅡ
chivu	ㅋㅣㅂㅜ
valentino	ㅂㅏㄹㄹㅔㄴㅌㅣㄴㅗ
rous	ㄹㅏㅇㅜㅅㅡ
jackman	ㅈㅐㄱㅁㅐㄴ
pratt	ㅍㅡㄹㅐㅅ
josie	ㅈㅗㅅㅣ
capshaw	ㅋㅐㅂㅅㅛ
arrigo	ㅇㅏㄹㅣㄱㅗ
koponen	ㅋㅗㅍㅗㄴㅔㄴ
vasilis	ㅂㅏㅅㅣㄹㄹㅣㅅㅡ
reis	ㅎㅔㅇㅣㅅㅡ
micah	ㅁㅣㅋㅏ
denzel	ㄷㅔㄴㅈㅓㄹ
tipton	ㅌㅣㅂㅌㅓㄴ
pettis	ㅍㅔㅌㅣㅅㅡ
schulz	ㅅㅠㄹㅊㅡ
roland	ㄹㅗㄹㄹㅏㄴㅌㅡ
gallo	ㄱㅐㄹㄹㅗ
raimi	ㄹㅔㅇㅣㅁㅣ
radcliffe	ㄹㅐㄷㅡㅋㅡㄹㄹㅣㅍㅡ
radek	ㄹㅏㄷㅔㅋㅡ
cha	ㅊㅏ
franco	ㅍㅡㄹㅏㅇㅋㅗ
barbaro	ㅂㅏㄹㅡㅂㅏㄹㅗ
pozzo	ㅍㅗㅊㅗ
masanao	ㅁㅏㅅㅏㄴㅏㅇㅗ
nuri	ㄴㅜㄹㅣ
freudenthal	ㅍㅡㄹㅗㅇㅣㄷㅔㄴㅌㅏㄹ
ingvar	ㅇㅣㅇㄱㅡㅂㅏㄹㅡ
jakobsson	ㅇㅑㅋㅗㅂㅅㅗㄴ
jong	ㅇㅛㅇ
bon	ㅂㅗㅇ
meredith	ㅁㅔㄹㅓㄷㅣㅅㅡ
koichi	ㅅㅡㄱㅣㅇㅑㅁㅏ
wilson	ㅇㅟㄹㅅㅡㄴ
aurora	ㅇㅗㄹㅗㄹㅏ
honey	ㅎㅓㄴㅣ
koster	ㅋㅗㅅㅡㅌㅓ
kaneko	ㅁㅏㅋㅗㅌㅗ
nolasco	ㄴㅗㄹㄹㅏㅅㅡㅋㅗ
akhtar	ㅇㅏㄱㅌㅏㄹㅡ
butcher	ㅂㅓㅊㅓ
hippolyte	ㅇㅣㅍㅗㄹㄹㅣㅌㅡ
monroe	ㅁㅓㄴㄹㅗ
trudeau	ㅌㅡㄹㅟㄷㅗ
sedgwick	ㅅㅔㅈㅡㅇㅟㄱ
callan	ㅋㅐㄹㄹㅓㄴ
norman	ㄴㅗㅁㅓㄴ
don	ㄷㅗㄴ
gilliam	ㄱㅣㄹㄹㅣㅇㅓㅁ
toivonen	ㅌㅗㅇㅣㅂㅗㄴㅔㄴ
mena	ㅁㅔㄴㅏ
deborah	ㄷㅔㅂㅓㄹㅓ
aizawa	ㅋㅔㅇㅣㅋㅗ
j	ㅈㅔㅇㅣ
jenner	ㅈㅔㄴㅓ
conway	ㅋㅗㄴㅇㅞㅇㅣ
childebert	ㅎㅣㄹㄷㅔㅂㅔㄹㅡㅌㅡ
ringo	ㄹㅣㅇㄱㅗ
gough	ㄱㅗㅍㅡ
dyson	ㄷㅏㅇㅣㅅㅡㄴ
anastasios	ㅇㅏㄴㅏㅅㅡㅌㅏㅅㅣㅇㅗㅅㅡ
cheyenne	ㅅㅑㅇㅣㅇㅔㄴ
alfie	ㅇㅏㄹㅍㅣ
bartosz	ㅂㅏㄹㅡㅌㅗㅅㅣ
panabaker	ㅍㅐㄴㅓㅂㅔㅇㅣㅋㅓ
jahangir	ㅈㅏㅎㅏㄴㄱㅣㄹㅡ
harmon	ㅎㅏㅁㅓㄴ
virgil	ㅂㅓㅈㅣㄹ
capra	ㅋㅏㅍㅡㄹㅏ
baruch	ㅂㅏㄹㅜㅋㅡ
del	ㄷㅔㄹ
sampaio	ㅅㅏㅁㅍㅏㅇㅣㅇㅜ
marquez	ㅁㅏㅋㅔㅈㅡ
gilpin	ㄱㅣㄹㅍㅣㄴ
valda	ㅂㅏㄹㄷㅏ
rocco	ㄹㅗㅋㅗ
kinnear	ㅋㅣㄴㅣㅇㅓ
padovani	ㅍㅏㄷㅗㅂㅏㄴㅣ
boz	ㅂㅗㅈㅡ
antonios	ㅇㅏㄴㅌㅗㄴㅣㅇㅗㅅㅡ
sharma	ㅅㅑㄹㅡㅁㅏ
shigenobu	ㅅㅣㄱㅔㄴㅗㅂㅜ
sylvia	ㅅㅣㄹㅂㅣㅇㅏ
muir	ㅁㅠㅇㅓ
jacobi	ㅇㅑㅋㅗㅂㅣ
danko	ㄷㅏㄴㅋㅗ
schilling	ㅅㅣㄹㄹㅣㅇ
tengku	ㅌㅔㅇㅋㅜ
chattopadhyay	ㅊㅏㅌㅗㅍㅏㄷㅣㅇㅏㅇㅑ
bunker	ㅂㅓㅇㅋㅓ
saddam	ㅅㅏㄷㅏㅁ
barton	ㅂㅏㅌㅓㄴ
barber	ㅂㅏㅂㅓ
krauss	ㅋㅡㄹㅏㅇㅜㅅㅡ
stepanova	ㅅㅡㅌㅔㅍㅏㄴㅗㅂㅏ
koen	ㅋㅜㄴ
ulla	ㅇㅜㄹㄹㅏ
ivica	ㅇㅣㅂㅣㅊㅏ
corbin	ㅋㅗㅂㅣㄴ
rossini	ㄹㅗㅅㅣㄴㅣ
dani	ㄷㅏㄴㅣ
beverley	ㅂㅔㅂㅓㄹㄹㅣ
hayes	ㅎㅔㅇㅣㅅㅡ
nicky	ㄴㅣㅋㅣ
brendan	ㅂㅡㄹㅔㄴㄷㅓㄴ
laure	ㄹㅗㄹㅡ
mendel	ㅁㅔㄴㄷㅔㄹ
ginzburg	ㄱㅣㄴㅊㅡㅂㅜㄹㅡㄱㅡ
martti	ㅁㅏㄹㅡㅌㅣ
larsen	ㄹㅏㅅㅡㄴ
lukaku	ㄹㅜㅋㅏㅋㅜ
trey	ㅌㅡㄹㅔㅇㅣ
yegorova	ㅇㅖㄱㅗㄹㅗㅂㅏ
eli	ㅇㅔㄹㄹㅣ
ramesses	ㄹㅏㅁㅅㅔㅅㅡ
farias	ㅍㅏㄹㅣㅇㅏㅅㅡ
ronald	ㄹㅗㄴㅓㄹㄷㅡ
shabana	ㅅㅑㅂㅏㄴㅏ
lene	ㄹㅔㄴㅔ
alba	ㅇㅏㄹㅂㅏ
jean	ㅈㅏㅇ
capuano	ㅋㅏㅍㅜㅇㅏㄴㅗ
campos	ㅋㅏㅁㅍㅗㅅㅡ
osborne	ㅇㅗㅈㅡㅂㅓㄴ
arielle	ㅇㅏㄹㅣㅇㅔㄹ
fesenko	ㅍㅔㅅㅔㄴㅋㅗ
carrera	ㅋㅏㄹㅔㄹㅏ
henley	ㅎㅔㄴㄹㅣ
finocchiaro	ㅍㅣㄴㅗㅋㅣㅇㅏㄹㅗ
wild	ㅇㅘㅇㅣㄹㄷㅡ
rudolph	ㄹㅜㄷㅗㄹㅍㅡ
yakov	ㅇㅑㅋㅗㅍㅡ
popov	ㅍㅗㅍㅗㅍㅡ
vinicius	ㅂㅣㄴㅣㅅㅣㅇㅜㅅㅡ
menzel	ㅁㅔㄴㅈㅔㄹ
wiseman	ㅇㅘㅇㅣㅈㅡㅁㅓㄴ
carver	ㅋㅏㅂㅓ
ted	ㅌㅔㄷㅡ
nobukazu	ㄴㅗㅂㅜㅋㅏㅈㅡ
chawla	ㅊㅏㅇㅜㄹㄹㅏ
mulroney	ㅁㅓㄹㄹㅗㄴㅣ
ramos	ㄹㅏㅁㅗㅅㅡ
papanikolaou	ㅍㅏㅍㅏㄴㅣㅋㅗㄹㄹㅏㅇㅜ
sandrine	ㅅㅏㅇㄷㅡㄹㅣㄴ
sorokin	ㅅㅗㄹㅗㅋㅣㄴ
can	ㅈㅏㄴ
bautista	ㅂㅏㅇㅜㅌㅣㅅㅡㅌㅏ
duane	ㄷㅜㅇㅔㅇㅣㄴ
gianluca	ㅈㅏㄴㄹㅜㅋㅏ
roscoe	ㄹㅗㅅㅡㅋㅗ
constantino	ㅋㅗㄴㅅㅡㅌㅏㄴㅌㅣㄴㅗ
nobumichi	ㄴㅗㅂㅜㅁㅣㅊㅣ
amaya	ㅇㅏㅁㅏㅇㅑ
rice	ㄹㅏㅇㅣㅅㅡ
adams	ㅇㅐㄷㅓㅁㅅㅡ
donizete	ㄷㅗㄴㅣㅈㅔㅊㅣ
guerreiro	ㄱㅔㄹㅔㅇㅣㄹㅜ
raeder	ㄹㅔㄷㅓ
jonny	ㅈㅗㄴㅣ
renault	ㄹㅡㄴㅗ
rupert	ㄹㅜㅍㅓㅌㅡ
chang	ㅊㅏㅇ
zamora	ㅈㅏㅁㅗㄹㅏ
brittany	ㅂㅡㄹㅣㅌㅡㄴㅣ
austin	ㅇㅗㅅㅡㅌㅣㄴ
brundage	ㅂㅡㄹㅓㄴㄷㅣㅈㅣ
claus	ㅋㅡㄹㄹㅏㅇㅜㅅㅡ
kazumasa	ㄱㅏㅈㅡㅁㅏㅅㅏ
alick	ㅇㅐㄹㄹㅣㄱ
yekaterina	ㅇㅖㅋㅏㅌㅔㄹㅣㄴㅏ
huizinga	ㅎㅏㅇㅟㅈㅣㅇㅇㅏ
rathbone	ㄹㅐㅅㅡㅂㅗㄴ
ferris	ㅍㅔㄹㅣㅅㅡ
anas	ㅇㅏㄴㅏㅅㅡ
trotta	ㅌㅡㄹㅗㅌㅏ
gholamreza	ㄱㅗㄹㄹㅏㅁㄹㅔㅈㅏ
lualua	ㄹㅜㅇㅏㄹㅜㅇㅏ
bebe	ㅂㅔㅂㅔ
seth	ㅅㅔㅅㅡ
kidd	ㅋㅣㄷㅡ
mar	ㅁㅏㄹㅡ
teri	ㅌㅔㄹㅣ
lawless	ㄹㅗㄹㄹㅣㅅㅡ
webb	ㅇㅞㅂ
maja	ㅁㅏㅇㅑ
sigismondo	ㅅㅣㅈㅣㅅㅡㅁㅗㄴㄷㅗ
benedito	ㅂㅔㄴㅔㄷㅣㅌㅗ
mihail	ㅁㅣㅎㅏㅇㅣㄹ
koirala	ㅋㅗㅇㅣㄹㅏㄹㄹㅏ
laurel	ㄹㅗㄹㅓㄹ
bass	ㅂㅐㅅㅡ
brooke	ㅂㅡㄹㅜㄱ
boll	ㅂㅗㄹ
sela	ㅅㅔㄹㄹㅏ
sebastiano	ㅅㅔㅂㅏㅅㅡㅌㅣㅇㅏㄴㅗ
ramadan	ㄹㅏㅁㅏㄷㅏㄴ
mauricio	ㅁㅏㅇㅜㄹㅣㅅㅣㅇㅗ
maximus	ㅁㅏㄱㅅㅣㅁㅜㅅㅡ
jeroen	ㅇㅖㄹㅜㄴ
carr	ㅋㅏ
kiyoshi	ㅋㅣㅇㅛㅅㅣ
gerard	ㅈㅔㄹㅏㄷㅡ
kamil	ㅋㅏㅁㅣㄹ
tadaharu	ㄷㅏㄷㅏㅎㅏㄹㅜ
stefano	ㅅㅡㅌㅔㅍㅏㄴㅗ
dorn	ㄷㅗㄴ
who	ㅎㅜ
paterson	ㅍㅐㅌㅓㅅㅡㄴ
davison	ㄷㅔㅇㅣㅂㅣㅅㅡㄴ
smit	ㅅㅡㅁㅣㅅ
scanlon	ㅅㅡㅋㅐㄴㄹㅗㄴ
hiroki	ㅇㅏㅈㅡㅁㅏ
slim	ㅅㅡㄹㄹㅣㅁ
griffiths	ㄱㅡㄹㅣㅍㅣㅅㅡ
neidhart	ㄴㅏㅇㅣㄷㅡㅎㅏㅌㅡ
pavel	ㅍㅏㅂㅔㄹ
fisher	ㅍㅣㅅㅕ
carlin	ㅋㅏㄹㄹㅣㄴ
matsumae	ㅁㅏㅆㅡㅁㅏㅇㅔ
idris	ㅇㅣㄷㅡㄹㅣㅅㅡ
mead	ㅁㅣㄷㅡ
brinkley	ㅂㅡㄹㅣㅇㅋㅡㄹㄹㅣ
carly	ㅋㅏㄹㄹㅣ
kummer	ㅋㅜㅁㅁㅓ
katherine	ㅋㅐㅅㅓㄹㅣㄴ
button	ㅂㅓㅌㅡㄴ
kuznetsova	ㅋㅜㅈㅡㄴㅔㅊㅗㅂㅏ
taha	ㅌㅏㅎㅏ
hannah	ㅎㅐㄴㅏ
hepburn	ㅎㅔㅂㅂㅓㄴ
wainwright	ㅇㅞㅇㅣㄴㄹㅏㅇㅣㅌㅡ
tadakatsu	ㄷㅏㄷㅏㅋㅏㅆㅡ
doillon	ㄷㅜㅇㅏㅇㅛㅇ
guillermo	ㄱㅣㅇㅖㄹㅡㅁㅗ
mariel	ㅁㅐㄹㅣㅇㅓㄹ
siebold	ㅈㅣㅂㅗㄹㅌㅡ
bruno	ㅂㅡㄹㅜㄴㅗ
evangelista	ㅇㅔㅂㅏㄴㅈㅔㄹㄹㅣㅅㅡㅌㅏ
johann	ㅇㅛㅎㅏㄴ
jon	ㅈㅗㄴ
lasse	ㄹㅏㅅㅔ
dash	ㄷㅐㅅㅣ
alina	ㅇㅏㄹㄹㅣㄴㅏ
finch	ㅍㅣㄴㅊㅣ
linh	ㄹㅣㄴ
idriss	ㅇㅣㄷㅡㄹㅣㅅㅡ
kama	ㅋㅏㅁㅏ
ramirez	ㄹㅏㅁㅣㄹㅔㅈㅡ
benson	ㅂㅔㄴㅅㅡㄴ
paraskevopoulos	ㅍㅏㄹㅏㅅㅡㅋㅔㅂㅗㅍㅜㄹㄹㅗㅅㅡ
bongo	ㅂㅗㅇㄱㅗ
leszek	ㄹㅔㅅㅖㅋㅡ
siegfried	ㅈㅣㄱㅡㅍㅡㄹㅣㄷㅡ
masakage	ㅁㅏㅅㅏㅋㅏㄱㅔ
osorio	ㅇㅗㅅㅗㄹㅣㅇㅗ
arias	ㅇㅏㄹㅣㅇㅏㅅㅡ
busey	ㅂㅜㅅㅣ
aileen	ㅇㅔㅇㅣㄹㄹㅣㄴ
osullivan	ㅇㅗㅅㅓㄹㄹㅣㅂㅓㄴ
clemente	ㅋㅡㄹㄹㅔㅁㅔㄴㅌㅔ
tiffany	ㅌㅣㅍㅓㄴㅣ
karavayev	ㅋㅏㄹㅏㅂㅏㅇㅖㅍㅡ
nikolai	ㄴㅣㅋㅗㄹㄹㅏㅇㅣ
burley	ㅂㅓㄹㄹㅣ
georgy	ㄱㅔㅇㅗㄹㅡㄱㅣ
callimachus	ㅋㅏㄹㄹㅣㅁㅏㅋㅗㅅㅡ
lucie	ㄹㅜㅅㅣ
jayson	ㅈㅔㅇㅣㅅㅡㄴ
bahram	ㅂㅏㅎㅡㄹㅏㅁ
hodges	ㅎㅗㅈㅣㅅㅡ
morozov	ㅁㅗㄹㅗㅈㅗㅍㅡ
persson	ㅍㅔㄹㅡㅅㅗㄴ
marin	ㅁㅏㄹㅣㄴ
pauline	ㅍㅗㄹㄹㅣㄴ
navas	ㄴㅏㅂㅏㅅㅡ
yamazaki	ㅁㅏㅅㅏㅌㅗ
larisa	ㄹㅏㄹㅣㅅㅏ
brendon	ㅂㅡㄹㅔㄴㄷㅓㄴ
blanchard	ㅂㅡㄹㄹㅐㄴㅊㅓㄷㅡ
grover	ㄱㅡㄹㅗㅂㅓ
manfredi	ㅁㅏㄴㅍㅡㄹㅔㄷㅣ
ashford	ㅇㅐㅅㅠㅍㅓㄷㅡ
badu	ㅂㅏㄷㅜ
mendoza	ㅁㅔㄴㄷㅗㅅㅏ
seidel	ㅈㅏㅇㅣㄷㅔㄹ
nadja	ㄴㅏㄷㅑ
farrell	ㅍㅐㄹㅓㄹ
gerald	ㅈㅔㄹㅓㄹㄷㅡ
aquino	ㅇㅏㅋㅣㄴㅗ
ricki	ㄹㅣㅋㅣ
finlay	ㅍㅣㄴㄹㅔㅇㅣ
emil	ㅇㅔㅁㅣㄹ
nerea	ㄴㅔㄹㅔㅇㅏ
keisha	ㅋㅔㅇㅣㅅㅑ
konstantinos	ㅋㅗㄴㅅㅡㅌㅏㄴㅌㅣㄴㅗㅅㅡ
angela	ㅇㅏㄴㅈㅔㄹㄹㅏ
lawton	ㄹㅗㅌㅓㄴ
mitchell	ㅁㅣㅊㅔㄹ
paola	ㅍㅏㅇㅗㄹㄹㅏ
adolf	ㅇㅏㄷㅗㄹㅍㅡ
mehmed	ㅁㅔㅎㅡㅁㅔㅌㅡ
gleason	ㄱㅡㄹㄹㅣㅅㅡㄴ
becky	ㅂㅔㅋㅣ
didier	ㄷㅣㄷㅣㅇㅔ
paine	ㅍㅔㅇㅣㄴ
stresemann	ㅅㅠㅌㅡㄹㅔㅈㅔㅁㅏㄴ
dusty	ㄷㅓㅅㅡㅌㅣ
hesse	ㅎㅔㅅㅔ
poitier	ㅍㅗㅇㅣㅌㅣㅇㅓ
spann	ㅅㅡㅍㅏㄴ
vinny	ㅂㅣㄴㅣ
isaak	ㅇㅏㅇㅣㅈㅏㄱ
rolland	ㄹㅗㄹㄹㅏㅇ
oleksandr	ㅇㅗㄹㄹㅔㄱㅅㅏㄴㄷㅡㄹㅡ
carol	ㅋㅐㄹㅓㄹ
hyde	ㅎㅏㅇㅣㄷㅡ
sergej	ㅅㅔㄹㅡㄱㅔㅇㅣ
greta	ㄱㅡㄹㅔㅌㅏ
bancroft	ㅂㅐㄴㅋㅡㄹㅗㅍㅡㅌㅡ
huffman	ㅎㅓㅍㅡㅁㅓㄴ
sofie	ㅅㅗㅍㅣ
leonel	ㄹㅔㅇㅗㄴㅔㄹ
hisako	ㅎㅣㅅㅏㅋㅗ
lindo	ㄹㅣㄴㄷㅗ
amaury	ㅇㅏㅁㅗㄹㅣ
leung	ㄹㅓㅇ
melvyn	ㅁㅔㄹㅂㅣㄴ
archibald	ㅇㅏㅊㅣㅂㅗㄹㄷㅡ
sandy	ㅅㅐㄴㄷㅣ
weaver	ㅇㅟㅂㅓ
betsy	ㅂㅔㅅㅅㅣ
tonkin	ㅌㅗㄴㅋㅣㄴ
mastroianni	ㅁㅏㅅㅡㅌㅡㄹㅗㅇㅑㄴㅣ
nogueira	ㄴㅗㄱㅔㅇㅣㄹㅏ
garrido	ㄱㅏㄹㅣㄷㅗ
kreutzer	ㅋㅡㄹㅗㅇㅣㅊㅓ
barnes	ㅂㅏㄴㅅㅡ
leblanc	ㄹㅡㅂㅡㄹㄹㅏㅇ
sage	ㅅㅔㅇㅣㅈㅣ
lorenz	ㄹㅗㄹㅔㄴㅊㅡ
orlando	ㅇㅗㄹㄹㅐㄴㄷㅗ
alva	ㅇㅏㄹㅂㅏ
willem	ㅂㅣㄹㄹㅓㅁ
connolly	ㅋㅗㄴㅓㄹㄹㅣ
eisenberg	ㅇㅏㅇㅣㅈㅔㄴㅂㅓㄱㅡ
lauryn	ㄹㅗㄹㅣㄴ
lozano	ㄹㅗㅅㅏㄴㅗ
nirenberg	ㄴㅣㄹㅓㄴㅂㅓㄱㅡ
nikolaus	ㄴㅣㅋㅗㄹㄹㅏㅇㅜㅅㅡ
ato	ㅇㅏㅌㅗ
faison	ㅍㅔㅇㅣㅅㅡㄴ
lily	ㄹㅣㄹㄹㅣ
lemay	ㄹㅡㅁㅔㅇㅣ
veli	ㅂㅔㄹㄹㅣ
weiss	ㅂㅏㅇㅣㅅㅡ
sadanaga	ㅅㅏㄷㅏㄴㅏㄱㅏ
lotta	ㄹㅗㅌㅏ
faulkner	ㅍㅗㅋㅡㄴㅓ
silveira	ㅅㅣㅇㅜㅂㅔㅇㅣㄹㅏ
zelda	ㅈㅔㄹㄷㅏ
kojima	ㄱㅗㅈㅣㅁㅏ
sven	ㅅㅡㅂㅔㄴ
perry	ㅍㅔㄹㅣ
cullen	ㅋㅓㄹㄹㅓㄴ
slaveykov	ㅅㅡㄹㄹㅏㅂㅔㅇㅣㅋㅗㅍㅡ
holman	ㅎㅗㄹㅁㅓㄴ
fats	ㅍㅐㅊㅡ
ilya	ㅇㅣㄹㄹㅣㅇㅑ
crow	ㅋㅡㄹㅗ
yul	ㅇㅠㄹ
dewan	ㄷㅡㅇㅘㄴ
selva	ㅅㅔㄹㅂㅏ
crompton	ㅋㅡㄹㅓㅁㅍㅡㅌㅓㄴ
gregor	ㄱㅡㄹㅔㄱㅗㄹㅡ
magnus	ㅁㅏㄱㅡㄴㅜㅅㅡ
iha	ㅇㅣㅎㅏ
loaf	ㄹㅗㅍㅡ
liszt	ㄹㅣㅅㅡㅌㅡ
errol	ㅇㅔㄹㅗㄹ
fred	ㅍㅡㄹㅔㄷㅡ
ewing	ㅇㅠㅇㅣㅇ
pavlov	ㅍㅏㅂㅡㄹㄹㅗㅍㅡ
satoru	ㅅㅡㅈㅡㅋㅣ
rocca	ㄹㅗㅋㅏ
yann	ㅇㅑㄴ
clemons	ㅋㅡㄹㄹㅔㅁㅓㄴㅅㅡ
hay	ㅎㅔㅇㅣ
snell	ㅅㅡㄴㅔㄹ
paullus	ㅍㅏㅇㅜㄹㄹㅜㅅㅡ
fenn	ㅍㅔㄴ
gleeson	ㄱㅡㄹㄹㅣㅅㅡㄴ
cobb	ㅋㅗㅂ
miguel	ㅁㅣㄱㅔㄹ
denys	ㄷㅔㄴㅣㅅㅡ
hyuna	ㅎㅕㄴㅇㅏ
hayward	ㅎㅔㅇㅣㅇㅝㄷㅡ
emre	ㅇㅔㅁㄹㅔ
tereza	ㅌㅔㄹㅔㅈㅏ
ward	ㅇㅝㄷㅡ
baran	ㅂㅏㄹㅏㄴ
gabriel	ㄱㅏㅂㅡㄹㅣㅇㅔㄹ
gosling	ㄱㅗㅅㅡㄹㄹㅣㅇ
graham	ㄱㅡㄹㅔㅇㅣㅇㅓㅁ
tadatsugu	ㄷㅏㄷㅏㅆㅡㄱㅜ
portman	ㅍㅗㅌㅡㅁㅓㄴ
fielding	ㅍㅣㄹㄷㅣㅇ
katt	ㅋㅐㅅ
locke	ㄹㅗㅋㅡ
falcon	ㅍㅐㄹㅋㅓㄴ
nwankwo	ㅇㅡㄴㅇㅘㄴㅋㅗ
gunn	ㄱㅓㄴ
ledley	ㄹㅔㄷㅡㄹㄹㅣ
basil	ㅂㅏㅅㅣㄹㄹㅣㅇㅜㅅㅡ
comencini	ㅋㅗㅁㅔㄴㅊㅣㄴㅣ
junius	ㅇㅠㄴㅣㅇㅜㅅㅡ
minelli	ㅁㅣㄴㅔㄹㄹㅣ
aman	ㅇㅏㅁㅏㄴ
olympia	ㅇㅗㄹㄹㅣㅁㅍㅣㅇㅏ
naldo	ㄴㅏㅇㅜㄷㅜ
bertie	ㅂㅓㅌㅣ
pilar	ㅍㅣㄹㄹㅏㄹㅡ
rosenfeld	ㄹㅗㅈㅔㄴㅍㅔㄹㄷㅡ
walther	ㅂㅏㄹㅌㅓ
jacks	ㅈㅐㄱㅅㅡ
fidel	ㅍㅣㄷㅔㄹ
lorenzo	ㄹㅗㄹㅔㄴㅊㅗ
masahiro	ㅁㅏㅅㅏㅎㅣㄹㅗ
dogg	ㄷㅗㄱ
buckingham	ㅂㅓㅋㅣㅇㅇㅓㅁ
kilmer	ㅋㅣㄹㅁㅓ
kodera	ㅋㅗㄷㅔㄹㅏ
kelli	ㅋㅔㄹㄹㅣ
samantha	ㅅㅓㅁㅐㄴㅅㅏ
florin	ㅍㅡㄹㄹㅗㄹㅣㄴ
marty	ㅁㅏㅌㅣ
aditya	ㅇㅏㄷㅣㅌㅡㅇㅑ
smits	ㅅㅡㅁㅣㅊㅡ
bakar	ㅂㅏㅋㅏㄹㅡ
whitney	ㅎㅟㅌㅡㄴㅣ
maud	ㅁㅗㄷㅡ
rory	ㄹㅗㄹㅣ
lara	ㄹㅏㄹㅏ
viktor	ㅂㅣㄱㅌㅗㄹㅡ
uchiyama	ㄷㅗㅅㅣㅎㅣㅋㅗ
mahmud	ㅁㅏㅎㅡㅁㅜㅌㅡ
keeping	ㅋㅣㅍㅣㅇ
heinrich	ㅎㅏㅇㅣㄴㄹㅣㅎㅣ
mbarek	ㅁㅡㅂㅏㄹㅔㅋㅡ
samba	ㅅㅏㅁㅂㅏ
majewski	ㅁㅏㅇㅖㅍㅡㅅㅡㅋㅣ
yevgeny	ㅇㅖㅂㅡㄱㅔㄴㅣ
gayle	ㄱㅔㅇㅣㄹ
egerton	ㅇㅔㅈㅓㅌㅓㄴ
tei	ㅌㅔㅇㅣ
yuichi	ㄴㅏㅋㅏㅁㅜㄹㅏ
rahn	ㄹㅏㄴ
nishio	ㄴㅣㅅㅣㅇㅗ
edmund	ㅇㅔㄷㅡㅁㅓㄴㄷㅡ
sorge	ㅈㅗㄹㅡㄱㅔ
doris	ㄷㅗㄹㅣㅅㅡ
aida	ㅇㅏㅇㅣㄷㅏ
livingston	ㄹㅣㅂㅣㅇㅅㅡㅌㅓㄴ
christa	ㅋㅡㄹㅣㅅㅡㅌㅏ
lynch	ㄹㅣㄴㅊㅣ
deol	ㄷㅔㅇㅗㄹ
oblak	ㅇㅗㅂㅡㄹㄹㅏㅋㅡ
salvador	ㅅㅏㄹㅂㅏㄷㅗㄹㅡ
funk	ㅍㅜㅇㅋㅡ
nam	ㄴㅏㅁ
wells	ㅇㅞㄹㅅㅡ
hamengkubuwono	ㅎㅏㅁㅔㅇㅋㅜㅂㅜㅇㅝㄴㅗ
tilly	ㅌㅣㄹㄹㅣ
dye	ㄷㅏㅇㅣ
jordana	ㅈㅗㄷㅓㄴㅏ
helle	ㅎㅔㄹㄹㅔ
rodrigues	ㅎㅗㄷㅡㄹㅣㄱㅔㅅㅡ
gianni	ㅈㅏㄴㄴㅣ
bowen	ㅂㅗㅇㅓㄴ
mentuhotep	ㅁㅔㄴㅌㅜㅎㅗㅌㅔㅍㅡ
landis	ㄹㅐㄴㄷㅣㅅㅡ
mimis	ㅁㅣㅁㅣㅅㅡ
vernon	ㅂㅓㄴㅗㄴ
veikko	ㅂㅔㅇㅣㅋㅗ
crazy	ㅋㅡㄹㅔㅇㅣㅈㅣ
dina	ㄷㅣㄴㅏ
kai	ㅋㅏㅇㅣ
patel	ㅍㅏㅌㅔㄹ
willy	ㅇㅟㄹㄹㅣ
rash	ㄹㅐㅅㅣ
kaplan	ㅋㅐㅍㅡㄹㄹㅓㄴ
crespo	ㅋㅡㄹㅔㅅㅡㅍㅗ
rose	ㄹㅗㅈㅡ
garret	ㄱㅐㄹㅣㅅ
rena	ㄹㅔㄴㅏ
justo	ㅎㅜㅅㅡㅌㅗ
fiore	ㅍㅣㅇㅗㄹㅔ
birthe	ㅂㅣㄹㅡㅌㅔ
hong	ㅎㅗㅇ
ignacy	ㅇㅣㄱㅡㄴㅏㅊㅣ
tagore	ㅌㅏㄱㅗㄹㅡ
veronese	ㅂㅔㄹㅗㄴㅔㅅㅔ
camacho	ㅋㅏㅁㅏㅊㅗ
krylov	ㅋㅡㄹㅣㄹㄹㅗㅍㅡ
errico	ㅇㅔㄹㅣㅋㅗ
murakami	ㅅㅣㄴㄱㅗ
shishkin	ㅅㅣㅅㅣㅋㅣㄴ
bibi	ㅂㅣㅂㅣ
roach	ㄹㅗㅊㅣ
pihkala	ㅍㅣㅎㅡㅋㅏㄹㄹㅏ
ames	ㅇㅔㅇㅣㅁㅅㅡ
harold	ㅎㅐㄹㅓㄹㄷㅡ
scotus	ㅅㅡㅋㅗㅌㅜㅅㅡ
mounir	ㅁㅜㄴㅣㄹㅡ
cassidy	ㅋㅐㅅㅣㄷㅣ
besbes	ㅂㅔㅅㅡㅂㅔㅅㅡ
barbora	ㅂㅏㄹㅡㅂㅗㄹㅏ
lvov	ㄹㅡㅂㅗㅍㅡ
arvydas	ㅇㅏㄹㅡㅂㅣㄷㅏㅅㅡ
bleibtreu	ㅂㅡㄹㄹㅏㅇㅣㅍㅡㅌㅡㄹㅗㅇㅣ
puri	ㅍㅜㄹㅣ
mallory	ㅁㅐㄹㄹㅓㄹㅣ
wang	ㅇㅘㅇ
tadayoshi	ㄷㅏㄷㅏㅇㅛㅅㅣ
illich	ㅇㅣㄹㄹㅣㅊㅣ
saint	ㅅㅓㅇ
livingstone	ㄹㅣㅂㅣㅇㅅㅡㅌㅓㄴ
masayuki	ㅁㅏㅅㅏㅇㅠㅋㅣ
lexi	ㄹㅔㄱㅅㅣ
joseph	ㅈㅗㅈㅣㅍㅡ
styles	ㅅㅡㅌㅏㅇㅣㄹㅅㅡ
muse	ㅁㅠㅈㅡ
alma	ㅇㅏㄹㅁㅏ
gaius	ㄱㅏㅇㅣㅇㅜㅅㅡ
emilio	ㅇㅔㅁㅣㄹㄹㅣㅇㅗ
janis	ㅈㅐㄴㅣㅅㅡ
carroll	ㅋㅐㄹㅓㄹ
rem	ㄹㅔㅁ
fleming	ㅍㅡㄹㄹㅔㅁㅣㅇ
timm	ㅌㅣㅁ
julien	ㅈㅟㄹㄹㅣㅇㅐㅇ
faust	ㅍㅏㅇㅜㅅㅡㅌㅡ
ronnie	ㄹㅗㄴㅣ
ogasawara	ㅇㅗㄱㅏㅅㅏㅇㅘㄹㅏ
messner	ㅁㅔㅅㅡㄴㅓ
sussman	ㅅㅓㅅㅡㅁㅓㄴ
masamori	ㅁㅏㅅㅏㅁㅗㄹㅣ
kirkland	ㅋㅓㅋㅡㄹㄹㅐㄴㄷㅡ
lombardi	ㄹㅗㅁㅂㅏㄹㅡㄷㅣ
kuhn	ㅋㅜㄴ
gries	ㄱㅡㄹㅣㅅㅡ
santino	ㅅㅏㄴㅌㅣㄴㅗ
ponce	ㅍㅗㄴㅅㅔ
stepanek	ㅅㅡㅌㅔㅍㅏㄴㅔㄱ
connery	ㅋㅗㄴㅓㄹㅣ
hardin	ㅎㅏㄷㅣㄴ
vic	ㅂㅣㄱ
welsh	ㅇㅞㄹㅅㅣ
baldwin	ㅂㅗㄹㄷㅡㅇㅟㄴ
levin	ㄹㅔㅂㅣㄴ
lucile	ㄹㅟㅅㅣㄹ
alphonse	ㅇㅏㄹㅍㅗㅇㅅㅡ
shuttarna	ㅅㅠㅌㅏㄹㅡㄴㅏ
davide	ㄷㅏㅂㅣㄷㅔ
bentley	ㅂㅔㄴㅌㅡㄹㄹㅣ
harding	ㅎㅏㄷㅣㅇ
sanai	ㅅㅏㄴㅏㅇㅣ
vita	ㅂㅣㅌㅏ
rao	ㄹㅏㅇㅗ
vicki	ㅂㅣㅋㅣ
chikatada	ㅈㅣㅋㅏㅌㅏㄷㅏ
shola	ㅅㅛㄹㄹㅏ
hildreth	ㅎㅣㄹㄷㅡㄹㅔㅅㅡ
kerr	ㅋㅓ
trofim	ㅌㅡㄹㅗㅍㅣㅁ
firth	ㅍㅓㅅㅡ
livius	ㄹㅣㅂㅣㅇㅜㅅㅡ
barry	ㅂㅐㄹㅣ
yonekura	ㅇㅛㄴㅔㅋㅜㄹㅏ
ambroise	ㅇㅏㅇㅂㅡㄹㅜㅇㅏㅈㅡ
bond	ㅂㅗㄴㄷㅡ
bakare	ㅂㅏㅋㅏㄹㅔ
hofstadter	ㅎㅗㅍㅡㅅㅡㅌㅐㅌㅓ
shimazu	ㅅㅣㅁㅏㅈㅡ
boots	ㅂㅜㅊㅡ
berkley	ㅂㅓㅋㅡㄹㄹㅣ
clegg	ㅋㅡㄹㄹㅔㄱㅡ
killer	ㅋㅣㄹㄹㅓ
giampaolo	ㅈㅏㅁㅍㅏㅇㅗㄹㄹㅗ
turturro	ㅌㅓㅌㅜㄹㅗ
melina	ㅁㅔㄹㄹㅣㄴㅏ
donatella	ㄷㅗㄴㅏㅌㅔㄹㄹㅏ
heard	ㅎㅓㄷㅡ
corneille	ㅋㅗㄹㅡㄴㅔㅇㅠ
carrie	ㅋㅐㄹㅣ
okeefe	ㅇㅗㅋㅣㅍㅡ
goulart	ㄱㅗㄹㄹㅏㄹㅡㅌㅡ
wakeman	ㅇㅞㅇㅣㅋㅡㅁㅓㄴ
gandhi	ㄱㅏㄴㄷㅣ
mars	ㅁㅏㅅㅡ
chambers	ㅊㅐㅁㅂㅓㅅㅡ
schleicher	ㅅㅠㄹㄹㅏㅇㅣㅎㅓ
evelyn	ㅇㅔㅂㅓㄹㄹㅣㄴ
daryl	ㄷㅏㄹㅣㄹ
lyudmila	ㄹㅠㄷㅡㅁㅣㄹㄹㅏ
peace	ㅍㅣㅅㅡ
gary	ㄱㅔㄹㅣ
orozco	ㅇㅗㄹㅗㅅㅡㅋㅗ
krahforst	ㅋㅡㄹㅏㅍㅗㄹㅡㅅㅡㅌㅡ
hayley	ㅎㅔㅇㅣㄹㄹㅣ
giambattista	ㅈㅏㅁㅂㅏㅌㅣㅅㅡㅌㅏ
mitsunaga	ㅁㅣㅆㅡㄴㅏㄱㅏ
moses	ㅁㅗㅈㅣㅅㅡ
mimmi	ㅁㅣㅁㅁㅣ
mato	ㅁㅏㅌㅗ
barreto	ㅂㅏㄹㅔㅌㅗ
nadine	ㄴㅏㄷㅣㄴ
irina	ㅇㅣㄹㅣㄴㅏ
tadanari	ㄷㅏㄷㅏㄴㅏㄹㅣ
kleist	ㅋㅡㄹㄹㅏㅇㅣㅅㅡㅌㅡ
jonathan	ㅈㅗㄴㅓㅅㅓㄴ
olsen	ㅇㅗㄹㅅㅡㄴ
to	ㅌㅜ
javier	ㅎㅏㅂㅣㅇㅔㄹㅡ
casey	ㅋㅔㅇㅣㅅㅣ
kuki	ㄱㅜㅋㅣ
svensson	ㅅㅡㅂㅔㄴㅅㅗㄴ
moshe	ㅁㅗㅅㅖ
blow	ㅂㅡㄹㄹㅗ
daisy	ㄷㅔㅇㅣㅈㅣ
uli	ㅇㅜㄹㄹㅣ
bosque	ㅂㅗㅅㅡㅋㅔ
voigt	ㅍㅗㅇㅣㅋㅡㅌㅡ
odonnell	ㅇㅗㄷㅗㄴㅓㄹ
jaan	ㅇㅑㄴ
kamel	ㅋㅏㅁㅔㄹ
makarov	ㅁㅏㅋㅏㄹㅗㅍㅡ
camargo	ㅋㅏㅁㅏㄹㅡㄱㅜ
hazlewood	ㅎㅔㅇㅣㅈㅡㄹㅇㅜㄷㅡ
carmen	ㅋㅏㄹㅡㅁㅔㄴ
marc	ㅁㅏㅋㅡ
gomis	ㄱㅗㅁㅣㅅㅡ
desmond	ㄷㅔㅈㅡㅁㅓㄴㄷㅡ
giorgos	ㅇㅛㄹㅡㄱㅗㅅㅡ
brad	ㅂㅡㄹㅐㄷㅡ
amor	ㅇㅏㅁㅗㄹㅡ
fabrizio	ㅍㅏㅂㅡㄹㅣㅊㅣㅇㅗ
irwin	ㅇㅓㅇㅟㄴ
rowland	ㄹㅗㄹㄹㅓㄴㄷㅡ
freire	ㅍㅡㄹㅔㅇㅣㄹㅔ
nichols	ㄴㅣㅋㅓㄹㅅㅡ
derrick	ㄷㅔㄹㅣㄱ
nilton	ㄴㅣㅇㅜㅌㅗㅇ
hutchison	ㅎㅓㅊㅣㅅㅡㄴ
cecily	ㅅㅔㅅㅣㄹㄹㅣ
josephine	ㅈㅗㅅㅔㅍㅣㄴ
alexandra	ㅇㅏㄹㄹㅔㄱㅅㅏㄴㄷㅡㄹㅏ
ware	ㅇㅞㅇㅓ
merrick	ㅁㅔㄹㅣㄱ
rickards	ㄹㅣㅋㅓㅈㅡ
boulami	ㅂㅜㄹㄹㅏㅁㅣ
sturridge	ㅅㅡㅌㅓㄹㅣㅈㅣ
gustaf	ㄱㅜㅅㅡㅌㅏㅍㅡ
kalla	ㅋㅏㄹㄹㅏ
annika	ㅇㅏㄴㄴㅣㅋㅏ
norris	ㄴㅗㄹㅣㅅㅡ
candice	ㅋㅐㄴㄷㅣㅅㅡ
annette	ㅇㅏㄴㅔㅌㅡ
dara	ㄷㅏㄹㅏ
yune	ㅇㅠㄴ
gene	ㅈㅣㄴ
wadlow	ㅇㅝㄷㅡㄹㄹㅗ
amell	ㅇㅏㅁㅔㄹ
lindsay	ㄹㅣㄴㅈㅣ
santoni	ㅅㅏㄴㅌㅗㄴㅣ
niki	ㄴㅣㅋㅣ
shelby	ㅅㅖㄹㅂㅣ
danny	ㄷㅐㄴㅣ
rene	ㄹㅔㄴㅔ
gold	ㄱㅗㄹㄷㅡ
gerhard	ㄱㅔㄹㅡㅎㅏㄹㅡㅌㅡ
yassin	ㅇㅑㅅㅣㄴ
rey	ㄹㅔㅇㅣ
soriano	ㅅㅗㄹㅣㅇㅏㄴㅗ
zidane	ㅈㅣㄷㅏㄴ
davey	ㄷㅔㅇㅣㅂㅣ
ondrej	ㅇㅗㄴㄷㅡㄹㅔㅇㅣ
geraldine	ㅈㅔㄹㅓㄹㄷㅣㄴ
silvestri	ㅅㅣㄹㅂㅔㅅㅡㅌㅡㄹㅣ
leonhard	ㄹㅔㅇㅗㄴㅎㅏㄹㅡㅌㅡ
lachlan	ㄹㅐㅋㅡㄹㄹㅓㄴ
ferrero	ㅍㅔㄹㅔㄹㅗ
iker	ㅇㅣㅋㅔㄹㅡ
horatio	ㅎㅗㄹㅔㅇㅣㅅㅛ
baynes	ㅂㅔㅇㅣㄴㅅㅡ
clement	ㅋㅡㄹㄹㅔㅁㅔㄴㅌㅡ
dagan	ㄷㅏㄱㅏㄴ
fyssas	ㅍㅣㅅㅏㅅㅡ
wolff	ㅇㅜㄹㅍㅡ
motochika	ㅁㅗㅌㅗㅊㅣㅋㅏ
lana	ㄹㅏㄴㅏ
cosimo	ㅋㅗㅅㅣㅁㅗ
porfirio	ㅍㅗㄹㅡㅍㅣㄹㅣㅇㅗ
o	ㅇㅗ
niko	ㄴㅣㅋㅗ
diesel	ㄷㅣㅈㅔㄹ
nance	ㄴㅐㄴㅅㅡ
louis	ㄹㅜㅇㅣ
oliver	ㅇㅗㄹㄹㅣㅂㅓ
avital	ㅇㅏㅂㅣㅌㅏㄹ
guyart	ㄱㅟㅇㅑㄹㅡ
facundo	ㅍㅏㅋㅜㄴㄷㅗ
hardwick	ㅎㅏㄷㅡㅇㅟㄱ
poul	ㅍㅗㅇㅜㄹ
tadakiyo	ㄷㅏㄷㅏㅋㅣㅇㅛ
wynter	ㅇㅟㄴㅌㅓ
ba	ㅂㅏ
giovanna	ㅈㅗㅂㅏㄴㄴㅏ
wilhelmina	ㅂㅣㄹㅎㅔㄹㅁㅣㄴㅏ
rios	ㄹㅣㅇㅗㅅㅡ
veblen	ㅂㅔㅂㅡㄹㄹㅓㄴ
dariusz	ㄷㅏㄹㅣㅇㅜㅅㅣ
du	ㄷㅟ
mackinnon	ㅁㅐㅋㅣㄴㅓㄴ
kyle	ㅋㅏㅇㅣㄹ
sorrentino	ㅅㅗㄹㅔㄴㅌㅣㄴㅗ
salah	ㅅㅏㄹㄹㅏ
lew	ㄹㅜ
arliss	ㅇㅏㄹㄹㅣㅅㅡ
charlton	ㅊㅏㄹㅌㅓㄴ
jessie	ㅈㅔㅅㅣ
hilpert	ㅎㅣㄹㅍㅔㄹㅡㅌㅡ
schubert	ㅅㅠㅂㅔㄹㅡㅌㅡ
lil	ㄹㅣㄹ
manley	ㅁㅐㄴㄹㅣ
nakayama	ㄴㅏㅋㅏㅇㅑㅁㅏ
klima	ㅋㅡㄹㄹㅣㅁㅏ
ihor	ㅇㅣㅎㅗㄹㅡ
mcgonigal	ㅁㅐㄱㄱㅗㄴㅣㄱㅓㄹ
rand	ㄹㅐㄴㄷㅡ
phoebe	ㅍㅣㅂㅣ
wainaina	ㅇㅘㅇㅣㄴㅏㅇㅣㄴㅏ
tadeusz	ㅌㅏㄷㅔㅇㅜㅅㅣ
hakan	ㅎㅏㅋㅏㄴ
knut	ㅋㅡㄴㅜㅌㅡ
ludvig	ㄹㅜㄷㅡㅂㅣ
galvin	ㄱㅐㄹㅂㅣㄴ
waldemar	ㅂㅏㄹㄷㅔㅁㅏㄹㅡ
alexandru	ㅇㅏㄹㄹㅔㄱㅅㅏㄴㄷㅡㄹㅜ
felix	ㅍㅔㄹㄹㅣㄱㅅㅡ
darius	ㄷㅏㄹㅣㅇㅜㅅㅡ
coelho	ㅋㅗㅇㅔㄹㄹㅠ
bobby	ㅂㅗㅂㅣ
mel	ㅁㅔㄹ
paavo	ㅍㅏㅂㅗ
mathis	ㅁㅐㅅㅣㅅㅡ
ardashir	ㅇㅏㄹㅡㄷㅏㅅㅣㄹㅡ
amat	ㅇㅏㅁㅏㅌㅡ
jusuf	ㅇㅠㅅㅜㅍㅡ
townsend	ㅌㅏㅇㅜㄴㅈㅔㄴㄷㅡ
barros	ㅂㅏㅎㅜㅅㅡ
moreno	ㅁㅗㄹㅔㄴㅗ
weston	ㅇㅞㅅㅡㅌㅓㄴ
west	ㅇㅞㅅㅡㅌㅡ
antonella	ㅇㅏㄴㅌㅗㄴㅔㄹㄹㅏ
aronson	ㅇㅔㄹㅓㄴㅅㅡㄴ
thornton	ㅅㅗㄴㅌㅓㄴ
olive	ㅇㅗㄹㄹㅣㅂㅡ
jakub	ㅇㅑㅋㅜㅍㅡ
sawyer	ㅅㅗㅇㅕ
hitchcock	ㅎㅣㅊㅣㅋㅗㄱ
evgeny	ㅇㅖㅂㅡㄱㅔㄴㅣ
augustin	ㅇㅗㄱㅟㅅㅡㅌㅐㅇ
defoe	ㄷㅣㅍㅗ
bose	ㅂㅗㅅㅡ
joshua	ㅈㅗㅅㅠㅇㅏ
lazar	ㄹㅏㅈㅏㄹㅡ
loufrani	ㄹㅜㅍㅡㄹㅏㄴㅣ
tory	ㅌㅗㄹㅣ
christina	ㅋㅡㄹㅣㅅㅡㅌㅣㄴㅏ
horton	ㅎㅗㅌㅓㄴ
gail	ㄱㅔㅇㅣㄹ
makoto	ㄱㅏㄴㅔㅋㅗ
teddy	ㅌㅔㄷㅣ
ida	ㅇㅣㄷㅏ
ogilvy	ㅇㅗㄱㅣㄹㅂㅣ
aurelio	ㅇㅏㅇㅜㄹㅔㄹㄹㅣㅇㅗ
pulido	ㅍㅜㄹㄹㅣㄷㅗ
mimi	ㅁㅣㅁㅣ
dumitrescu	ㄷㅜㅁㅣㅌㅡㄹㅔㅅㅡㅋㅜ
batista	ㅂㅏㅌㅣㅅㅡㅌㅏ
arne	ㅇㅏㄹㅡㄴㅔ
alfonso	ㅇㅏㄹㅍㅗㄴㅅㅗ
tierney	ㅌㅣㅇㅓㄴㅣ
pugh	ㅍㅠ
zaytsev	ㅈㅏㅇㅣㅊㅔㅍㅡ
linus	ㄹㅏㅇㅣㄴㅓㅅㅡ
fritz	ㅍㅡㄹㅣㅊㅡ
ter	ㅌㅔㄹㅡ
todd	ㅌㅗㄷㅡ
palacios	ㅍㅏㄹㄹㅏㅅㅣㅇㅗㅅㅡ
spyridon	ㅅㅡㅍㅣㄹㅣㄷㅗㄴ
micheline	ㅁㅣㅅㅖㄹㄹㅣㄴ
rimi	ㄹㅣㅁㅣ
mikhail	ㅁㅣㅎㅏㅇㅣㄹ
bryce	ㅂㅡㄹㅏㅇㅣㅅㅡ
lucky	ㄹㅓㅋㅣ
camilla	ㅋㅏㅁㅣㄹㄹㅏ
shigeyoshi	ㅅㅣㄱㅔㅇㅛㅅㅣ
willow	ㅇㅟㄹㄹㅗ
yutaka	ㅇㅠㅌㅏㅋㅏ
marcelo	ㅁㅏㄹㅡㅅㅔㄹㄹㅗ
pence	ㅍㅔㄴㅅㅡ
vuk	ㅂㅜㅋㅡ
murray	ㅁㅓㄹㅣ
bregy	ㅂㅡㄹㅔㄱㅣ
trapp	ㅌㅡㄹㅏㅍㅡ
grimes	ㄱㅡㄹㅏㅇㅣㅁㅅㅡ
mchale	ㅁㅐㄱㅎㅔㅇㅣㄹ
sheen	ㅅㅣㄴ
sohn	ㅅㅗㄴ
hamlin	ㅎㅐㅁㄹㅣㄴ
brigitte	ㅂㅡㄹㅣㅈㅣㅌㅡ
grieg	ㄱㅡㄹㅣㄱㅡ
uta	ㅇㅜㅌㅏ
sonya	ㅅㅗㄴㅑ
akiyama	ㅇㅏㅋㅣㅇㅑㅁㅏ
borodin	ㅂㅗㄹㅗㄷㅣㄴ
michelle	ㅁㅣㅅㅖㄹ
brook	ㅂㅡㄹㅜㄱ
alexei	ㅇㅏㄹㄹㅔㄱㅅㅔㅇㅣ
naganao	ㄴㅏㄱㅏㄴㅏㅇㅗ
margaret	ㅁㅏㄱㅓㄹㅣㅅ
jo	ㅈㅗ
boyer	ㅂㅗㅇㅣㅇㅓ
lerche	ㄹㅔㄹㅡㅋㅔ
moon	ㅁㅜㄴ
miller	ㅁㅣㄹㄹㅓ
youngblood	ㅇㅕㅇㅂㅡㄹㄹㅓㄷㅡ
minnie	ㅁㅣㄴㅣ
kroenke	ㅋㅡㄹㅏㅇㅋㅣ
alaric	ㅇㅏㄹㄹㅏㄹㅣㅋㅡ
cosgrove	ㅋㅗㅅㅡㄱㅡㄹㅗㅂㅡ
saif	ㅅㅏㅇㅣㅍㅡ
daly	ㄷㅔㅇㅣㄹㄹㅣ
brie	ㅂㅡㄹㅣ
hull	ㅎㅓㄹ
murchison	ㅁㅓㅊㅣㅅㅡㄴ
foote	ㅍㅜㅌㅡ
robyn	ㄹㅗㅂㅣㄴ
ogier	ㅇㅗㅈㅣㅇㅔ
ventimiglia	ㅂㅔㄴㅌㅣㅁㅣㄹㄹㅣㅇㅏ
moura	ㅁㅗㄹㅏ
emir	ㅇㅔㅁㅣㄹㅡ
monika	ㅁㅗㄴㅣㅋㅏ
kirkman	ㅋㅓㅋㅡㅁㅓㄴ
curci	ㅋㅜㄹㅡㅊㅣ
wertheimer	ㅂㅔㄹㅡㅌㅡㅎㅏㅇㅣㅁㅓ
bailey	ㅂㅔㅇㅣㄹㄹㅣ
petr	ㅍㅔㅌㅡㄹㅡ
parks	ㅍㅏㅋㅡㅅㅡ
ivana	ㅇㅣㅂㅏㄴㅏ
boban	ㅂㅗㅂㅏㄴ
reiser	ㄹㅏㅇㅣㅈㅓ
gibb	ㄱㅣㅂ
margarita	ㅁㅏㄱㅏㄹㅣㅌㅏ
fletcher	ㅍㅡㄹㄹㅔㅊㅓ
kershaw	ㅋㅓㅅㅛ
kazuki	ㅅㅏㅌㅗ
mansour	ㅁㅏㄴㅅㅜㄹㅡ
kelechi	ㅋㅔㄹㄹㅔㅊㅣ
coleen	ㅋㅗㄹㄹㅣㄴ
pedro	ㅍㅔㄷㅡㄹㅗ
onishi	ㅇㅗㄴㅣㅅㅣ
italo	ㅇㅣㅌㅏㄹㄹㅗ
sibel	ㅅㅣㅂㅔㄹ
pavlova	ㅍㅏㅂㅡㄹㄹㅗㅂㅏ
mountbatten	ㅁㅏㅇㅜㄴㅌㅡㅂㅐㅌㅡㄴ
farro	ㅍㅐㄹㅗ
noyce	ㄴㅗㅇㅣㅅㅡ
joao	ㅎㅗㅇㅏㅇㅗ
mikheil	ㅁㅣㅎㅏㅇㅣㄹ
marika	ㅁㅏㄹㅣㅋㅏ
keys	ㅋㅣㅅㅡ
aleksandr	ㅇㅏㄹㄹㅔㄱㅅㅏㄴㄷㅡㄹㅡ
morales	ㅁㅗㄹㅏㄹㄹㅔㅅㅡ
simonetta	ㅅㅣㅁㅗㄴㅔㅌㅏ
atkinson	ㅇㅐㅅㅋㅣㄴㅅㅡㄴ
saeed	ㅅㅏㅇㅣㄷㅡ
epps	ㅇㅔㅂㅅㅡ
rider	ㄹㅏㅇㅣㄷㅓ
edouard	ㅇㅔㄷㅜㅇㅏㄹㅡ
judith	ㅈㅜㄷㅣㅅㅡ
andreas	ㅇㅏㄴㄷㅡㄹㅔㅇㅏㅅㅡ
ascanio	ㅇㅏㅅㅡㅋㅏㄴㅣㅇㅗ
cousins	ㅋㅓㅈㅡㄴㅅㅡ
yoo	ㅇㅠ
chaplin	ㅊㅐㅍㅡㄹㄹㅣㄴ
cornish	ㅋㅗㄴㅣㅅㅣ
oscar	ㅇㅗㅅㅡㅋㅏㄹㅡ
susan	ㅅㅜㅈㅓㄴ
filip	ㅍㅣㄹㄹㅣㅍㅡ
kleiber	ㅋㅡㄹㄹㅏㅇㅣㅂㅓ
garrett	ㄱㅐㄹㅣㅅ
appiani	ㅇㅏㅍㅣㅇㅏㄴㅣ
roy	ㄹㅗㅇㅣ
wolfe	ㅇㅜㄹㅍㅡ
patterson	ㅍㅐㅌㅓㅅㅡㄴ
meirelles	ㅁㅔㅇㅣㄹㅔㄹㄹㅣㅅㅡ
vimala	ㅂㅣㅁㅏㄹㄹㅏ
benito	ㅂㅔㄴㅣㅌㅗ
brennan	ㅂㅡㄹㅔㄴㅓㄴ
johanna	ㅇㅛㅎㅏㄴㅏ
yoshiaki	ㅇㅛㅅㅣㅇㅏㅋㅣ
ary	ㅇㅏㄹㅣ
philippe	ㅍㅣㄹㄹㅣㅍㅡ
ninomiya	ㅎㅣㄹㅗㅅㅣ
giambi	ㅈㅣㅇㅏㅁㅂㅣ
bergson	ㅂㅔㄹㅡㄱㅡㅅㅗㅇ
nellie	ㄴㅔㄹㄹㅣ
rommel	ㄹㅗㅁㅁㅔㄹ
nuno	ㄴㅜㄴㅜ
renan	ㅎㅔㄴㅏㅇ
drahun	ㄷㅡㄹㅏㅎㅜㄴ
andersen	ㅇㅏㄴㄷㅔㄹㅡㅅㅔㄴ
diodotus	ㄷㅣㅇㅗㄷㅗㅌㅗㅅㅡ
matsumoto	ㅈㅜㄴ
hewlett	ㅎㅠㄹㄹㅔㅅ
josef	ㅇㅛㅅㅔㅍㅡ
kross	ㅋㅡㄹㅗㅅㅡ
masashige	ㅁㅏㅅㅏㅅㅣㄱㅔ
donna	ㄷㅗㄴㅏ
selby	ㅅㅔㄹㅂㅣ
glen	ㄱㅡㄹㄹㅔㄴ
ferreyra	ㅍㅔㄹㅔㅇㅣㄹㅏ
seale	ㅅㅣㄹ
zia	ㅈㅣㅇㅏ
watanabe	ㅇㅘㅌㅏㄴㅏㅂㅔ
travers	ㅌㅡㄹㅐㅂㅓㅅㅡ
brett	ㅂㅡㄹㅔㅅ
lonergan	ㄹㅗㄴㅓㄱㅓㄴ
talbot	ㅌㅐㄹㅂㅓㅅ
vanilla	ㅂㅏㄴㅣㄹㄹㅏ
jackson	ㅈㅐㄱㅅㅡㄴ
wanderson	ㅇㅘㄴㄷㅔㄹㅡㅅㅗㅇ
king	ㅋㅣㅇ
ivan	ㅇㅣㅂㅏㄴ
hess	ㅎㅔㅅㅡ
helen	ㅎㅔㄹㄹㅔㄴ
marguerite	ㅁㅏㄹㅡㄱㅡㄹㅣㅌㅡ
masoud	ㅁㅏㅅㅜㄷㅡ
bloom	ㅂㅡㄹㄹㅜㅁ
regan	ㄹㅣㄱㅓㄴ
pim	ㅍㅣㅁ
fredy	ㅍㅡㄹㅔㄷㅣ
tani	ㄷㅏㄴㅣ
oneill	ㅇㅗㄴㅣㄹ
berger	ㅂㅔㄹㅡㄱㅓ
nobumitsu	ㄴㅗㅂㅜㅁㅣㅆㅡ
garay	ㄱㅏㄹㅏㅇㅣ
winkler	ㅂㅣㅇㅋㅡㄹㄹㅓ
royal	ㄹㅗㅇㅕㄹ
lange	ㄹㅏㅇㄱㅔ
pau	ㅍㅏㅇㅜ
chopra	ㅊㅗㅍㅡㄹㅏ
daron	ㄷㅏㄹㅗㄴ
demy	ㄷㅔㅁㅣ
aleksandra	ㅇㅏㄹㄹㅔㄱㅅㅏㄴㄷㅡㄹㅏ
kirby	ㅋㅓㅂㅣ
shigemune	ㅅㅣㄱㅔㅁㅜㄴㅔ
yeltsin	ㅇㅖㄹㅊㅣㄴ
card	ㅋㅏㄷㅡ
grzegorz	ㄱㅡㅈㅔㄱㅗㅅㅣ
aldridge	ㅇㅏㄹㄷㅡㄹㅣㅈㅣ
frye	ㅍㅡㄹㅏㅇㅣ
johnson	ㅈㅗㄴㅅㅡㄴ
guido	ㄱㅟㄷㅗ
gian	ㅈㅏㄴ
rain	ㄹㅔㅇㅣㄴ
daniels	ㄷㅐㄴㅣㅇㅓㄹㅅㅡ
rifkin	ㄹㅣㅍㅡㅋㅣㄴ
fourier	ㅍㅜㄹㅣㅇㅔ
pozzi	ㅍㅗㅊㅣ
nguyen	ㅇㅡㅇㅇㅜㅇㅖㄴ
dimitris	ㄷㅣㅁㅣㅌㅡㄹㅣㅅㅡ
doubleday	ㄷㅓㅂㅡㄹㄷㅔㅇㅣ
yoshika	ㅇㅛㅅㅣㅋㅏ
travis	ㅌㅡㄹㅐㅂㅣㅅㅡ
butler	ㅂㅓㅌㅡㄹㄹㅓ
brewer	ㅂㅡㄹㅜㅇㅓ
schauman	ㅅㅑㅇㅜㅁㅏㄴ
kelley	ㅋㅔㄹㄹㅣ
post	ㅍㅗㅅㅡㅌㅡ
jun	ㅅㅡㅈㅡㅋㅣ
weil	ㅂㅔㅇㅠ
minogue	ㅁㅣㄴㅗㄱㅡ
caitlin	ㅋㅔㅇㅣㅌㅡㄹㄹㅣㄴ
starlin	ㅅㅡㅌㅏㄹㄹㅣㄴ
maslow	ㅁㅐㅅㅡㄹㄹㅗ
lewis	ㄹㅜㅇㅣㅅㅡ
heike	ㅎㅏㅇㅣㅋㅔ
wally	ㅇㅝㄹㄹㅣ
eduard	ㅇㅔㄷㅜㅇㅏㄹㅡㅌㅡ
martina	ㅁㅏㄹㅡㅌㅣㄴㅏ
signorelli	ㅅㅣㄴㅛㄹㅔㄹㄹㅣ
lenz	ㄹㅔㄴㅊㅡ
gupta	ㄱㅜㅂㅌㅏ
baxter	ㅂㅐㄱㅅㅡㅌㅓ
tove	ㅌㅗㅂㅔ
mascarenhas	ㅁㅏㅅㅡㅋㅏㄹㅔㄴㅑㅅㅡ
haynes	ㅎㅔㅇㅣㄴㅅㅡ
parkinson	ㅍㅏㅋㅣㄴㅅㅡㄴ
leno	ㄹㅔㄴㅗ
escudero	ㅇㅔㅅㅡㅋㅜㄷㅔㄹㅗ
adele	ㅇㅏㄷㅔㄹ
max	ㅁㅏㄱㅅㅡ
tadasada	ㄷㅏㄷㅏㅅㅏㄷㅏ
gilchrist	ㄱㅣㄹㅋㅡㄹㅣㅅㅡㅌㅡ
vinson	ㅂㅣㄴㅅㅡㄴ
moffat	ㅁㅗㅍㅐㅅ
chloe	ㅋㅡㄹㄹㅗㅇㅣ
ciriaco	ㅊㅣㄹㅣㅇㅏㅋㅗ
summer	ㅅㅓㅁㅓ
wan	ㅇㅘㄴ
aubry	ㅇㅗㅂㅡㄹㅣ
heather	ㅎㅔㄷㅓ
gerrit	ㄱㅔㄹㅣㅅ
maciej	ㅁㅏㅊㅣㅇㅔㅇㅣ
lawrence	ㄹㅗㄹㅓㄴㅅㅡ
jadhav	ㅈㅏㄷㅏㅂㅡ
astor	ㅇㅐㅅㅡㅌㅓ
judy	ㅈㅜㄷㅣ
kapoor	ㅋㅏㅍㅜㄹㅡ
borel	ㅂㅗㄹㅔㄹ
diehl	ㄷㅣㄹ
dewey	ㄷㅠㅇㅣ
tissier	ㅌㅣㅅㅣㅇㅔ
hendrick	ㅎㅔㄴㄷㅡㄹㅣㄱ
burton	ㅂㅓㅌㅓㄴ
oluf	ㅇㅗㄹㄹㅜㅍㅡ
pollack	ㅍㅗㄹㄹㅏㄱ
wolf	ㅂㅗㄹㅍㅡ
boston	ㅂㅗㅅㅡㅌㅓㄴ
rainer	ㄹㅏㅇㅣㄴㅓ
mota	ㅁㅗㅌㅏ
boulanger	ㅂㅜㄹㄹㅏㅇㅈㅔ
otoole	ㅇㅗㅌㅜㄹ
eden	ㅇㅣㄷㅡㄴ
tainio	ㅌㅏㅇㅣㄴㅣㅇㅗ
mojo	ㅁㅗㅈㅗ
georgia	ㅈㅗㅈㅣㅇㅏ
forrest	ㅍㅗㄹㅔㅅㅡㅌㅡ
vitaly	ㅂㅣㅌㅏㄹㄹㅣ
amira	ㅇㅏㅁㅣㄹㅏ
melora	ㅁㅔㄹㄹㅗㄹㅏ
pontius	ㅍㅗㄴㅌㅣㅇㅜㅅㅡ
turnbull	ㅌㅓㄴㅂㅜㄹ
wafaa	ㅇㅘㅍㅏ
chen	ㅊㅔㄴ
betty	ㅂㅔㅌㅣ
zahid	ㅈㅏㅎㅣㄷㅡ
farka	ㅍㅏㄹㅡㅋㅏ
biz	ㅂㅣㅈㅡ
polo	ㅍㅗㄹㄹㅗ
becker	ㅂㅔㅋㅓ
judd	ㅈㅓㄷㅡ
anderzon	ㅇㅏㄴㄷㅔㄹㅡㅅㅗㄴ
ashlynn	ㅇㅐㅅㅠㄹㄹㅣㄴ
weinberg	ㅇㅘㅇㅣㄴㅂㅓㄱㅡ
vaughn	ㅂㅗㄴ
meta	ㅁㅔㅌㅏ
berta	ㅂㅔㄹㅡㅌㅏ
guilfoyle	ㄱㅣㄹㅍㅗㅇㅣㄹ
george	ㅈㅗㅈㅣ
radhika	ㄹㅏㄷㅣㅋㅏ
shirakawa	ㅊㅓㄴㅎㅘㅇ
stevie	ㅅㅡㅌㅣㅂㅣ
duncan	ㄷㅓㅇㅋㅓㄴ
mladen	ㅁㅡㄹㄹㅏㄷㅔㄴ
vedran	ㅂㅔㄷㅡㄹㅏㄴ
sivan	ㅅㅣㅂㅏㄴ
tenzing	ㅌㅔㄴㅈㅣㅇ
tsiklitiras	ㅊㅣㅋㅡㄹㄹㅣㅌㅣㄹㅏㅅㅡ
johanne	ㅇㅛㅎㅏㄴㅔ
kristine	ㅋㅡㄹㅣㅅㅡㅌㅣㄴ
dal	ㄷㅏㄹ
nashimoto	ㄴㅏㅅㅣㅁㅗㅌㅗㄴㅗㅁㅣㅇㅑ
bryant	ㅂㅡㄹㅏㅇㅣㅇㅓㄴㅌㅡ
appiah	ㅇㅏㅍㅣㅇㅏ
man	ㅁㅐㄴ
de	ㄷㅔ
mara	ㅁㅏㄹㅏ
guy	ㄱㅏㅇㅣ
rodrigo	ㄹㅗㄷㅡㄹㅣㄱㅗ
white	ㅎㅘㅇㅣㅌㅡ
purdy	ㅍㅓㄷㅣ
miss	ㅁㅣㅅㅡ
land	ㄹㅐㄴㄷㅡ
carbonero	ㅋㅏㄹㅡㅂㅗㄴㅔㄹㅗ
lincoln	ㄹㅣㅇㅋㅓㄴ
matteo	ㅁㅏㅌㅔㅇㅗ
finn	ㅍㅣㄴ
silas	ㅅㅏㅇㅣㄹㄹㅓㅅㅡ
sakuma	ㅅㅏㅋㅜㅁㅏ
chad	ㅊㅐㄷㅡ
siemens	ㅈㅣㅁㅔㄴㅅㅡ
kamei	ㄱㅏㅁㅔㅇㅣ
sukemasa	ㅅㅡㅋㅔㅁㅏㅅㅏ
mello	ㅁㅔㄹㄹㅜ
haze	ㅎㅔㅇㅣㅈㅡ
blaise	ㅂㅡㄹㄹㅔㅈㅡ
alyaksandr	ㅇㅏㄹㄹㅑㄱㅅㅏㄴㄷㅡㄹㅡ
agostini	ㅇㅏㄱㅗㅅㅡㅌㅣㄴㅣ
billy	ㅂㅣㄹㄹㅣ
marcel	ㅁㅏㄹㅡㅅㅔㄹ
garrison	ㄱㅐㄹㅣㅅㅡㄴ
sofia	ㅅㅗㅍㅣㅇㅏ
laurie	ㄹㅗㄹㅣ
algirdas	ㅇㅏㄹㄱㅣㄹㅡㄷㅏㅅㅡ
hogan	ㅎㅗㄱㅓㄴ
shields	ㅅㅣㄹㅈㅡ
franka	ㅍㅡㄹㅏㅇㅋㅏ
gunilla	ㄱㅜㄴㅣㄹㄹㅏ
terence	ㅌㅔㄹㅓㄴㅅㅡ
nussbaum	ㄴㅜㅅㅡㅂㅏㅇㅜㅁ
kris	ㅋㅡㄹㅣㅅㅡ
busch	ㅂㅜㅅㅟ
soria	ㅅㅗㄹㅣㅇㅏ
ardian	ㅇㅏㄹㅡㄷㅣㅇㅏㄴ
graf	ㄱㅡㄹㅏㅍㅡ
clare	ㅋㅡㄹㄹㅔㅇㅓ
kerkhof	ㅋㅔㄹㅡㅋㅡㅎㅗㅍㅡ
rahman	ㄹㅏㅁㅏㄴ
leonard	ㄹㅔㄴㅓㄷㅡ
inoue	ㅇㅣㄴㅗㅇㅜㅇㅔ
troisi	ㅌㅡㄹㅗㅇㅣㅅㅣ
conradin	ㅋㅗㄴㄹㅏㄷㅣㄴ
marconi	ㅁㅏㄹㅡㅋㅗㄴㅣ
carli	ㅋㅏㄹㄹㅣ
milligan	ㅁㅣㄹㄹㅣㄱㅓㄴ
penny	ㅍㅔㄴㅣ
greene	ㄱㅡㄹㅣㄴ
rowe	ㄹㅗ
tomlinson	ㅌㅗㅁㄹㅣㄴㅅㅡㄴ
inna	ㅇㅣㄴㄴㅏ
edith	ㅇㅔㄷㅣㅅㅡ
maguire	ㅁㅐㄱㅘㅇㅣㅇㅓ
megan	ㅁㅔㄱㅓㄴ
holst	ㅎㅗㄹㅅㅡㅌㅡ
hannes	ㅎㅏㄴㅔㅅㅡ
iris	ㅇㅏㅇㅣㄹㅣㅅㅡ
scipio	ㅅㅡㅋㅣㅍㅣㅇㅗ
agnes	ㅇㅏㄱㅡㄴㅔㅅㅡ
solano	ㅅㅗㄹㄹㅏㄴㅗ
tadamitsu	ㄷㅏㄷㅏㅁㅣㅆㅡ
amiri	ㅇㅏㅁㅣㄹㅣ
valdez	ㅂㅏㄹㄷㅔㅅㅡ
cat	ㅋㅐㅅ
redding	ㄹㅔㄷㅣㅇ
flynn	ㅍㅡㄹㄹㅣㄴ
mo	ㅁㅗ
wendell	ㅇㅞㄴㄷㅔㄹ
nicklas	ㄴㅣㅋㅡㄹㄹㅏㅅㅡ
kelly	ㅋㅔㄹㄹㅣ
sheehan	ㅅㅣㅎㅐㄴ
samaras	ㅅㅏㅁㅏㄹㅏㅅㅡ
latimer	ㄹㅐㅌㅣㅁㅓ
aelia	ㅇㅏㅇㅣㄹㄹㅣㅇㅏ
ulf	ㅇㅜㄹㅍㅡ
natalie	ㄴㅐㅌㅓㄹㄹㅣ
julius	ㅇㅠㄹㄹㅣㅇㅜㅅㅡ
kuroda	ㄱㅜㄹㅗㄷㅏ
seamus	ㅅㅣㅁㅓㅅㅡ
krupp	ㅋㅡㄹㅜㅍㅡ
dillinger	ㄷㅣㄹㄹㅣㄴㅈㅓ
bohr	ㅂㅗㅇㅓ
javi	ㅎㅏㅂㅣ
sakakibara	ㅅㅏㅋㅏㅋㅣㅂㅏㄹㅏ
nye	ㄴㅏㅇㅣ
vasili	ㅂㅏㅅㅣㄹㄹㅣ
benelli	ㅂㅔㄴㅔㄹㄹㅣ
corinne	ㅋㅗㄹㅣㄴ
noble	ㄴㅗㅂㅡㄹ
clancy	ㅋㅡㄹㄹㅐㄴㅅㅣ
laila	ㄹㅏㅇㅣㄹㄹㅏ
garson	ㄱㅏㅅㅡㄴ
hal	ㅎㅏㄹ
pigott	ㅍㅣㄱㅗㅅ
spelling	ㅅㅡㅍㅔㄹㄹㅣㅇ
pepper	ㅍㅔㅍㅓ
higgs	ㅎㅣㄱㅅㅡ
nagayoshi	ㄴㅏㄱㅏㅇㅛㅅㅣ
usher	ㅇㅓㅅㅕ
tiberius	ㅌㅣㅂㅔㄹㅣㅇㅜㅅㅡ
rapace	ㄹㅏㅍㅏㅅㅡ
lindsey	ㄹㅣㄴㅈㅣ
otto	ㅇㅗㅌㅗ
satoshi	ㅇㅑㅁㅏㄱㅜㅊㅣ
gutierrez	ㄱㅜㅌㅣㅇㅔㄹㅔㅅㅡ
yamamoto	ㅇㅑㅁㅏㅁㅗㅌㅗ
konrad	ㅋㅗㄴㄹㅏㅌㅡ
yasuteru	ㅇㅑㅅㅡㅌㅔㄹㅜ
sutcliffe	ㅅㅓㅌㅡㅋㅡㄹㄹㅣㅍㅡ
dorian	ㄷㅗㄹㅣㅇㅓㄴ
helene	ㅎㅔㄹㄹㅔㄴㅔ
valois	ㅂㅏㄹㄹㅜㅇㅏ
kim	ㅋㅣㅁ
stout	ㅅㅡㅌㅏㅇㅜㅌㅡ
katina	ㅋㅏㅌㅣㄴㅏ
eino	ㅇㅔㅇㅣㄴㅗ
cosgrave	ㅋㅗㅈㅡㄱㅡㄹㅔㅇㅣㅂㅡ
lorraine	ㄹㅗㄹㅔㄴ
nobunori	ㄴㅗㅂㅜㄴㅗㄹㅣ
gropius	ㄱㅡㄹㅗㅍㅣㅇㅜㅅㅡ
welby	ㅇㅞㄹㅂㅣ
choniates	ㅋㅗㄴㅣㅇㅏㅌㅔㅅㅡ
kohn	ㅋㅗㄴ
yusuke	ㄱㅗㅂㅏㅇㅑㅅㅣ
hanns	ㅎㅏㄴㅅㅡ
bjarnason	ㅂㅣㅇㅏㄹㅡㄷㅡㄴㅏㅅㅗㄴ
gago	ㄱㅏㄱㅗ
fawcett	ㅍㅗㅅㅔㅅ
mathias	ㅁㅏㅌㅣㅇㅏㅅㅡ
tracy	ㅌㅡㄹㅔㅇㅣㅅㅣ
brandy	ㅂㅡㄹㅐㄴㄷㅣ
willie	ㅇㅟㄹㄹㅣ
tatyana	ㅌㅏㅌㅣㅇㅑㄴㅏ
bliss	ㅂㅡㄹㄹㅣㅅㅡ
eugenio	ㅇㅔㅇㅜㅈㅔㄴㅣㅇㅗ
hadley	ㅎㅐㄷㅡㄹㄹㅣ
bolz	ㅂㅗㄹㅊㅡ
rutherford	ㄹㅓㄷㅓㅍㅓㄷㅡ
namgyal	ㄴㅏㅁㄱㅑㄹ
yannick	ㅇㅑㄴㅣㄱ
tadanao	ㄷㅏㄷㅏㄴㅏㅇㅗ
orson	ㅇㅗㅅㅡㄴ
girolamo	ㅈㅣㄹㅗㄹㄹㅏㅁㅗ
delia	ㄷㅔㄹㄹㅣㅇㅏ
seigner	ㅅㅔㄴㅣㅇㅔㄹㅡ
zombie	ㅈㅗㅁㅂㅣ
hadji	ㅎㅏㅈㅣ
neumann	ㄴㅗㅇㅣㅁㅏㄴ
camara	ㅋㅏㅁㅏㄹㅏ
goffman	ㄱㅗㅍㅡㅁㅏㄴ
tadamasa	ㄷㅏㄷㅏㅁㅏㅅㅏ
dern	ㄷㅓㄴ
lynn	ㄹㅣㄴ
chavez	ㅊㅏㅂㅔㅅㅡ
roald	ㄹㅗㅇㅏㄹㄷㅡ
len	ㄹㅔㄴ
cronin	ㅋㅡㄹㅗㄴㅣㄴ
waite	ㅇㅞㅇㅣㅌㅡ
giannis	ㅇㅑㄴㅣㅅㅡ
tutu	ㅌㅜㅌㅜ
brady	ㅂㅡㄹㅐㄷㅣ
peters	ㅍㅣㅌㅓㅅㅡ
ko	ㅋㅗ
brian	ㅂㅡㄹㅏㅇㅣㅇㅓㄴ
kristian	ㅋㅡㄹㅣㅅㅡㅌㅣㅇㅏㄴ
hyemi	ㅎㅖㅁㅣ
fran	ㅍㅡㄹㅐㄴ
tokugawa	ㄷㅗㅋㅜㄱㅏㅇㅘ
mats	ㅁㅏㅊㅡ
sandberg	ㅅㅐㄴㄷㅡㅂㅓㄱㅡ
chikayoshi	ㅈㅣㅋㅏㅇㅛㅅㅣ
eller	ㅇㅔㄹㄹㅓ
anushka	ㅇㅏㄴㅜㅅㅠㅋㅏ
somoza	ㅅㅗㅁㅗㅅㅏ
winstone	ㅇㅟㄴㅅㅡㅌㅗㄴ
masasada	ㅁㅏㅅㅏㅅㅏㄷㅏ
holloway	ㅎㅗㄹㄹㅓㅇㅞㅇㅣ
merian	ㅁㅔㄹㅣㅇㅏㄴ
richter	ㄹㅣㅎㅣㅌㅓ
bergen	ㅂㅓㄱㅓㄴ
horio	ㅎㅗㄹㅣㅇㅗ
hailey	ㅎㅔㅇㅣㄹㄹㅣ
musashi	ㅁㅜㅅㅏㅅㅣ
anna	ㅇㅏㄴㄴㅏ
karina	ㅋㅏㄹㅣㄴㅏ
shilpa	ㅅㅣㄹㅍㅏ
tavernier	ㅌㅏㅂㅔㄹㅡㄴㅣㅇㅔ
manny	ㅁㅐㄴㅣ
cullum	ㅋㅓㄹㄹㅓㅁ
watkins	ㅇㅘㅅㅋㅣㄴㅅㅡ
francesca	ㅍㅡㄹㅏㄴㅊㅔㅅㅡㅋㅏ
soares	ㅅㅗㅇㅏㄹㅔㅅㅡ
nicolaus	ㄴㅣㅋㅗㄹㄹㅏㅇㅜㅅㅡ
solomon	ㅅㅗㄹㄹㅗㅁㅗㄴ
harri	ㅎㅏㄹㅣ
teller	ㅌㅔㄹㄹㅓ
jacek	ㅇㅑㅊㅔㅋㅡ
uwe	ㅇㅜㅂㅔ
edge	ㅇㅔㅈㅣ
tavares	ㅌㅏㅂㅏㄹㅔㅅㅡ
tadazane	ㄷㅏㄷㅏㅈㅏㄴㅔ
battista	ㅂㅏㅌㅣㅅㅡㅌㅏ
hampton	ㅎㅐㅁㅍㅡㅌㅓㄴ
bogdan	ㅂㅗㄱㅡㄷㅏㄴ
solberg	ㅅㅗㄹㅂㅔㄹㅡㄱㅡ
nicolae	ㄴㅣㅋㅗㄹㄹㅏㅇㅔ
ayesha	ㅇㅏㅇㅖㅅㅑ
malia	ㅁㅏㄹㄹㅣㅇㅏ
vargas	ㅂㅏㄹㅡㄱㅏㅅㅡ
weir	ㅇㅟㅇㅓ
milena	ㅁㅣㄹㄹㅔㄴㅏ
donner	ㄷㅗㄴㅓ
einstein	ㅇㅏㅇㅣㄴㅅㅠㅌㅏㅇㅣㄴ
birkhoff	ㅂㅓㅋㅗㅍㅡ
sunshine	ㅅㅓㄴㅅㅑㅇㅣㄴ
alice	ㅇㅐㄹㄹㅣㅅㅡ
dmitri	ㄷㅡㅁㅣㅌㅡㄹㅣ
murdoch	ㅁㅓㄷㅗㄱ
sonja	ㅅㅗㄴㅑ
prieto	ㅍㅡㄹㅣㅇㅔㅌㅗ
tudhaliya	ㅌㅜㄷㅡㅎㅏㄹㄹㅣㅇㅑ
nazarov	ㄴㅏㅈㅏㄹㅗㅍㅡ
nick	ㄴㅣㄱ
stjepan	ㅅㅡㅊㅔㅍㅏㄴ
saul	ㅅㅗㄹ
genie	ㅈㅣㄴㅣ
kan	ㄱㅣㅋㅜㅊㅣ
johns	ㅈㅗㄴㅅㅡ
sasaki	ㅎㅣㅌㅗㅅㅣ
mateo	ㅁㅏㅌㅔㅇㅗ
page	ㅍㅔㅇㅣㅈㅣ
oday	ㅇㅗㄷㅔㅇㅣ
kluge	ㅋㅡㄹㄹㅜㄱㅔ
caetano	ㅋㅏㅇㅔㅌㅏㄴㅜ
southern	ㅅㅓㄷㅓㄴ
claudel	ㅋㅡㄹㄹㅗㄷㅔㄹ
thom	ㅌㅗㅁ
sleepy	ㅅㅡㄹㄹㅣㅍㅣ
wassily	ㅂㅏㅅㅣㄹㄹㅣ
mcclure	ㅁㅐㅋㅡㄹㄹㅜㅇㅓ
donovan	ㄷㅗㄴㅓㅂㅓㄴ
hadid	ㅎㅏㄷㅣㄷㅡ
rue	ㄹㅜ
phil	ㅍㅣㄹ
bowman	ㅂㅗㅁㅓㄴ
long	ㄹㅗㅇ
milos	ㅁㅣㄹㄹㅗㅅㅣ
hearst	ㅎㅓㅅㅡㅌㅡ
gamal	ㄱㅏㅁㅏㄹ
johansson	ㅇㅛㅎㅏㄴㅅㅗㄴ
quentin	ㅋㅞㄴㅌㅣㄴ
lessing	ㄹㅔㅅㅣㅇ
maggie	ㅁㅐㄱㅣ
petar	ㅍㅔㅌㅏㄹㅡ
salih	ㅅㅏㄹㄹㅣㅎㅡ
fanny	ㅍㅏㄴㅣ
ram	ㄹㅏㅁ
adolfo	ㅇㅏㄷㅗㄹㅍㅗ
shapley	ㅅㅒㅍㅡㄹㄹㅣ
dawson	ㄷㅗㅅㅡㄴ
bohuslav	ㅂㅗㅎㅜㅅㅡㄹㄹㅏㅍㅡ
kostas	ㅋㅗㅅㅡㅌㅏㅅㅡ
sinan	ㅅㅣㄴㅏㄴ
manning	ㅁㅐㄴㅣㅇ
mcmanus	ㅁㅐㄱㅁㅏㄴㅜㅅㅡ
aleksey	ㅇㅏㄹㄹㅔㄱㅅㅔㅇㅣ
k	ㅋㅔㅇㅣ
nicole	ㄴㅣㅋㅗㄹ
ould	ㅇㅜㄹㄷㅡ
frederic	ㅍㅡㄹㅔㄷㅓㄹㅣㄱ
gheorghe	ㄱㅔㅇㅗㄹㅡㄱㅔ
doherty	ㄷㅗㅎㅓㅌㅣ
kyla	ㅋㅏㅇㅣㄹㄹㅏ
mikhalkov	ㅁㅣㅎㅏㄹㅋㅗㅍㅡ
giorgio	ㅈㅗㄹㅡㅈㅗ
jillian	ㅈㅣㄹㄹㅣㅇㅓㄴ
haigh	ㅎㅔㅇㅣㄱㅡ
hidalgo	ㅇㅣㄷㅏㄹㄱㅗ
hristo	ㅎㅡㄹㅣㅅㅡㅌㅗ
fernandez	ㅍㅔㄹㅡㄴㅏㄴㄷㅔㅅㅡ
casilla	ㅋㅏㅅㅣㅇㅑ
robinson	ㄹㅗㅂㅣㄴㅅㅡㄴ
jeremiah	ㅈㅔㄹㅓㅁㅏㅇㅣㅇㅏ
tachibana	ㄷㅏㅊㅣㅂㅏㄴㅏ
haasan	ㅎㅏㅅㅏㄴ
talley	ㅌㅐㄹㄹㅣ
allison	ㅇㅐㄹㄹㅣㅅㅡㄴ
hormizd	ㅎㅗㄹㅡㅁㅣㅈㅡㄷㅡ
paloma	ㅍㅏㄹㄹㅗㅁㅏ
rosendahl	ㄹㅗㅈㅔㄴㄷㅏㄹ
canning	ㅋㅐㄴㅣㅇ
ikoma	ㅇㅣㅋㅗㅁㅏ
theo	ㅌㅔㅇㅗ
llorente	ㅇㅛㄹㅔㄴㅌㅔ
raven	ㄹㅔㅇㅣㅂㅡㄴ
shapiro	ㅅㅑㅍㅣㄹㅗ
nero	ㄴㅔㄹㅗ
lillard	ㄹㅣㄹㄹㅓㄷㅡ
kenzo	ㅅㅡㅈㅡㅋㅣ
margot	ㅁㅏㄱㅗ
mikkelsen	ㅁㅣㅋㅔㄹㅅㅔㄴ
nicholson	ㄴㅣㅋㅓㄹㅅㅡㄴ
campofregoso	ㅋㅏㅁㅍㅗㅍㅡㄹㅔㄱㅗㅅㅗ
darren	ㄷㅐㄹㅓㄴ
che	ㅊㅔ
farina	ㅍㅏㄹㅣㄴㅏ
vivian	ㅂㅣㅂㅣㅇㅓㄴ
rivers	ㄹㅣㅂㅓㅅㅡ
pablo	ㅍㅏㅂㅡㄹㄹㅗ
anson	ㅇㅐㄴㅅㅡㄴ
michalis	ㅁㅣㅎㅏㄹㄹㅣㅅㅡ
mayer	ㅁㅏㅇㅣㅇㅓ
gammal	ㄱㅏㅁㅏㄹ
javad	ㅈㅏㅂㅏㄷㅡ
roberts	ㄹㅗㅂㅓㅊㅡ
giuseppe	ㅈㅜㅅㅔㅍㅔ
marta	ㅁㅏㄹㅡㅌㅏ
xavier	ㅅㅏㅂㅣㅇㅔㄹㅡ
kebede	ㅋㅔㅂㅔㄷㅔ
mears	ㅁㅣㅇㅓㅅㅡ
pop	ㅍㅏㅂ
springer	ㅅㅡㅍㅡㄹㅣㅇㄱㅓ
ursula	ㅇㅜㄹㅡㅈㅜㄹㄹㅏ
zack	ㅈㅐㄱ
jay	ㅈㅔㅇㅣ
stipe	ㅅㅡㅌㅣㅍㅔ
todorov	ㅌㅗㄷㅗㄹㅗㅍㅡ
janine	ㅈㅏㄴㅣㄴ
stoller	ㅅㅡㅌㅗㄹㄹㅓ
walid	ㅇㅘㄹㄹㅣㄷㅡ
gaston	ㄱㅏㅅㅡㅌㅗㅇ
heath	ㅎㅣㅅㅡ
riley	ㄹㅏㅇㅣㄹㄹㅣ
elettra	ㅇㅔㄹㄹㅔㅌㅡㄹㅏ
darin	ㄷㅐㄹㅣㄴ
star	ㅅㅡㅌㅏ
romeo	ㄹㅗㅁㅣㅇㅗ
gogh	ㄱㅗㅎㅡ
hershey	ㅎㅓㅅㅣ
henstridge	ㅎㅔㄴㅅㅡㅌㅡㄹㅣㅈㅣ
nancy	ㄴㅐㄴㅅㅣ
blanc	ㅂㅡㄹㄹㅏㅇ
hooks	ㅎㅜㄱㅅㅡ
haig	ㅎㅔㅇㅣㄱㅡ
rei	ㄹㅔㅇㅣ
cindy	ㅅㅣㄴㄷㅣ
alla	ㅇㅏㄹㄹㅏ
abel	ㅇㅏㅂㅔㄹ
holmes	ㅎㅗㅁㅅㅡ
morris	ㅁㅗㄹㅣㅅㅡ
donald	ㄷㅗㄴㅓㄹㄷㅡ
rafik	ㄹㅏㅍㅣㅋㅡ
serov	ㅅㅔㄹㅗㅍㅡ
emerson	ㅇㅔㅁㅓㅅㅡㄴ
kapodistrias	ㅋㅏㅍㅗㄷㅣㅅㅡㅌㅡㄹㅣㅇㅏㅅㅡ
quayle	ㅋㅞㅇㅣㄹ
charley	ㅊㅏㄹㄹㅣ
sadanobu	ㅅㅏㄷㅏㄴㅗㅂㅜ
ball	ㅂㅗㄹ
beckham	ㅂㅔㅋㅓㅁ
adelaide	ㅇㅐㄷㅡㄹㄹㅔㅇㅣㄷㅡ
sky	ㅅㅡㅋㅏㅇㅣ
malone	ㅁㅓㄹㄹㅗㄴ
manson	ㅁㅐㄴㅅㅡㄴ
sergio	ㅅㅔㄹㅡㅎㅣㅇㅗ
tatum	ㅌㅔㅇㅣㅌㅓㅁ
lafferty	ㄹㅐㅍㅓㅌㅣ
korda	ㅋㅗㄹㅡㄷㅏ
hoyt	ㅎㅗㅇㅣㅌㅡ
dominika	ㄷㅗㅁㅣㄴㅣㅋㅏ
mayall	ㅁㅔㅇㅣㅇㅗㄹ
aubrey	ㅇㅗㅂㅡㄹㅣ
douglas	ㄷㅓㄱㅡㄹㄹㅓㅅㅡ
sabine	ㅅㅏㅂㅣㄴ
romulus	ㄹㅗㅁㅜㄹㄹㅜㅅㅡ
boyle	ㅂㅗㅇㅣㄹ
lungu	ㄹㅜㅇㄱㅜ
nurmi	ㄴㅜㄹㅡㅁㅣ
darwish	ㄷㅏㄹㅡㅇㅟㅅㅣ
cerezo	ㅅㅔㄹㅔㅅㅗ
gallagher	ㄱㅐㄹㄹㅓㄱㅓ
ned	ㄴㅔㄷㅡ
sheikh	ㅅㅖㅇㅣㅋㅡ
raphael	ㄹㅏㅍㅏㅇㅔㄹ
filho	ㅍㅣㄹㄹㅠ
nanbu	ㄴㅏㄴㅂㅜ
erin	ㅇㅔㄹㅣㄴ
faure	ㅍㅗㄹㅡ
spector	ㅅㅡㅍㅔㄱㅌㅓ
nenad	ㄴㅔㄴㅏㄷㅡ
strauss	ㅅㅠㅌㅡㄹㅏㅇㅜㅅㅡ
frankel	ㅍㅡㄹㅐㅇㅋㅡㄹ
pacheco	ㅍㅏㅊㅔㅋㅗ
albrecht	ㅇㅏㄹㅂㅡㄹㅔㅎㅣㅌㅡ
dante	ㄷㅏㄴㅌㅔ
jacobson	ㅈㅔㅇㅣㅋㅓㅂㅅㅡㄴ
raoul	ㄹㅏㅇㅜㄹ
bentivoglio	ㅂㅔㄴㅌㅣㅂㅗㄹㄹㅣㅇㅗ
bob	ㅂㅏㅂ
plant	ㅍㅡㄹㄹㅐㄴㅌㅡ
georges	ㅈㅗㄹㅡㅈㅜ
magomedov	ㅁㅏㄱㅗㅁㅔㄷㅗㅍㅡ
gaby	ㄱㅏㅂㅣ
esteban	ㅇㅔㅅㅡㅌㅔㅂㅏㄴ
yitzhak	ㅇㅣㅊㅡㅎㅏㅋㅡ
jost	ㅇㅛㅅㅡㅌㅡ
dubois	ㄷㅟㅂㅜㅇㅏ
blackwell	ㅂㅡㄹㄹㅐㄱㅇㅞㄹ
schmitz	ㅅㅠㅁㅣㅊㅡ
amalfitano	ㅇㅏㅁㅏㄹㅍㅣㅌㅏㄴㅗ
joni	ㅈㅗㄴㅣ
weimann	ㅂㅏㅇㅣㅁㅏㄴ
altman	ㅇㅗㄹㅌㅡㅁㅓㄴ
dunham	ㄷㅓㄴㅓㅁ
hugh	ㅎㅠ
criss	ㅋㅡㄹㅣㅅㅡ
gerardo	ㅎㅔㄹㅏㄹㅡㄷㅗ
vicious	ㅂㅣㅅㅕㅅㅡ
downey	ㄷㅏㅇㅜㄴㅣ
frans	ㅍㅡㄹㅏㄴㅅㅡ
aragon	ㅇㅏㄹㅏㄱㅗㄴ
abdel	ㅇㅏㅂㄷㅔㄹ
tomasz	ㅌㅗㅁㅏㅅㅣ
maldini	ㅁㅏㄹㄷㅣㄴㅣ
whitaker	ㅎㅟㅌㅓㅋㅓ
mcguire	ㅁㅐㄱㄱㅘㅇㅣㅇㅓ
klein	ㅋㅡㄹㄹㅏㅇㅣㄴ
li	ㄹㅣ
quinn	ㅋㅟㄴ
valente	ㅂㅏㄹㄹㅔㄴㅌㅡ
matsuda	ㄱㅔㄴㅌㅏ
lu	ㄹㅜ
reilly	ㄹㅔㅇㅣㄹㄹㅣ
cochran	ㅋㅗㅋㅡㄹㅐㄴ
deluise	ㄷㅓㄹㅜㅇㅣㅈㅡ
sergiu	ㅅㅔㄹㅡㅈㅣㅇㅜ
gill	ㄱㅣㄹ
yana	ㅇㅑㄴㅏ
ognjen	ㅇㅗㄱㅡㄴㅔㄴ
jefferson	ㅈㅔㅍㅓㅅㅡㄴ
shunsuke	ㄴㅏㅋㅏㅁㅜㄹㅏ
loftus	ㄹㅗㅍㅡㅌㅓㅅㅡ
khosrau	ㅎㅗㅅㅡㄹㅗ
toshihisa	ㄷㅗㅅㅣㅎㅣㅅㅏ
lena	ㄹㅔㄴㅏ
yoshitaka	ㅇㅛㅅㅣㅌㅏㅋㅏ
federico	ㅍㅔㄷㅔㄹㅣㅋㅗ
agrippa	ㅇㅏㄱㅡㄹㅣㅍㅏ
ahmad	ㅇㅏㅎㅡㅁㅏㄷㅡ
alexandros	ㅇㅏㄹㄹㅔㄱㅅㅏㄴㄷㅡㄹㅗㅅㅡ
andy	ㅇㅐㄴㄷㅣ
blier	ㅂㅡㄹㄹㅣㅇㅔ
lila	ㄹㅣㄹㄹㅏ
dj	ㄷㅣㅈㅔㅇㅣ
catalina	ㅋㅏㅌㅏㄹㅣㄴㅏ
kirov	ㅋㅣㄹㅗㅍㅡ
mart	ㅁㅏㄹㅡㅌㅡ
hendricks	ㅎㅔㄴㄷㅡㄹㅣㄱㅅㅡ
ty	ㅌㅏㅇㅣ
flack	ㅍㅡㄹㄹㅐㄱ
dean	ㄷㅣㄴ
daisuke	ㅅㅏㅇㅣㅌㅗ
nacho	ㄴㅏㅊㅗ
findlay	ㅍㅣㄴㄷㅡㄹㄹㅔㅇㅣ
sotirios	ㅅㅗㅌㅣㄹㅣㅇㅗㅅㅡ
beyer	ㅂㅏㅇㅣㅇㅓ
barrientos	ㅂㅏㄹㅣㅇㅔㄴㅌㅗㅅㅡ
bournonville	ㅂㅜㄹㅡㄴㅗㅇㅂㅣㄹ
ellsworth	ㅇㅔㄹㅅㅡㅇㅝㅅㅡ
bud	ㅂㅓㄷㅡ
aharon	ㅇㅏㅎㅏㄹㅗㄴ
sousa	ㅅㅗㅈㅏ
mick	ㅁㅣㄱ
navarrete	ㄴㅏㅂㅏㄹㅔㅌㅔ
jeongjong	ㅈㅓㅇㅈㅗㅇ
wiggins	ㅇㅟㄱㅣㄴㅅㅡ
oriana	ㅇㅗㄹㅣㅇㅏㄴㅏ
akimoto	ㅇㅏㅋㅣㅁㅗㅌㅗ
attenborough	ㅇㅏㅌㅔㄴㅂㅓㄹㅓ
nobutomo	ㄴㅗㅂㅜㅌㅗㅁㅗ
mcgee	ㅁㅐㄱㄱㅣ
sandro	ㅅㅏㄴㄷㅡㄹㅗ
nora	ㄴㅗㄹㅏ
troy	ㅌㅡㄹㅗㅇㅣ
valerio	ㅂㅏㄹㄹㅔㄹㅣㅇㅗ
galloway	ㄱㅐㄹㄹㅓㅇㅞㅇㅣ
elliott	ㅇㅔㄹㄹㅣㅇㅓㅅ
metaxas	ㅁㅔㅌㅏㄱㅅㅏㅅㅡ
witt	ㅂㅣㅌㅡ
mascarita	ㅁㅏㅅㅡㅋㅏㄹㅣㅌㅏ
pauli	ㅍㅏㅇㅜㄹㄹㅣ
vidmar	ㅂㅣㄷㅡㅁㅏ
reddick	ㄹㅔㄷㅣㄱ
rui	ㅎㅜㅇㅣ
luckinbill	ㄹㅓㅋㅣㄴㅂㅣㄹ
santos	ㅅㅏㄴㅌㅜㅅㅡ
sanchez	ㅅㅏㄴㅊㅔㅅㅡ
guru	ㄱㅜㄹㅜ
cumming	ㅋㅓㅁㅣㅇ
martyn	ㅁㅏㅌㅣㄴ
dick	ㄷㅣㄱ
haris	ㅎㅏㄹㅣㅅㅡ
mineiro	ㅁㅣㄴㅔㅇㅣㄹㅜ
gamble	ㄱㅐㅁㅂㅡㄹ
padilla	ㅍㅏㄷㅣㅇㅑ
anastasia	ㅇㅏㄴㅏㅅㅡㅌㅏㅅㅑ
doe	ㄷㅗ
yancey	ㅇㅑㄴㅅㅣ
antti	ㅇㅏㄴㅌㅣ
vlada	ㅂㅡㄹㄹㅏㄷㅏ
meg	ㅁㅔㄱㅡ
aleksei	ㅇㅏㄹㄹㅔㄱㅅㅔㅇㅣ
fine	ㅍㅏㅇㅣㄴ
evans	ㅇㅔㅂㅓㄴㅅㅡ
poppy	ㅍㅏㅍㅣ
callen	ㅋㅐㄹㄹㅓㄴ
bahar	ㅂㅏㅎㅏㄹㅡ
hippias	ㅎㅣㅍㅣㅇㅏㅅㅡ
carmona	ㅋㅏㄹㅡㅁㅗㄴㅏ
royce	ㄹㅗㅇㅣㅅㅡ
alois	ㅇㅏㄹㄹㅗㅇㅣㅅㅡ
anatoliy	ㅇㅏㄴㅏㅌㅗㄹㄹㅣ
lea	ㄹㅔㅇㅏ
dyer	ㄷㅏㅇㅣㅇㅓ
cy	ㅅㅏㅇㅣ
giancarlo	ㅈㅏㄴㅋㅏㄹㅡㄹㄹㅗ
evelin	ㅇㅔㅂㅔㄹㄹㅣㄴ
cavendish	ㅋㅐㅂㅓㄴㄷㅣㅅㅣ
theophilus	ㅌㅔㅇㅗㅍㅣㄹㄹㅜㅅㅡ
amadou	ㅇㅏㅁㅏㄷㅜ
teodoro	ㅌㅔㅇㅗㄷㅗㄹㅗ
medici	ㅁㅔㄷㅣㅊㅣ
tammy	ㅌㅐㅁㅣ
kosor	ㅋㅗㅅㅗㄹㅡ
barkley	ㅂㅏㅋㅡㄹㄹㅣ
mariusz	ㅁㅏㄹㅣㅇㅜㅅㅣ
wingfield	ㅇㅟㅇㅍㅣㄹㄷㅡ
ila	ㅇㅣㄹㄹㅏ
fiala	ㅍㅣㅇㅏㄹㄹㅏ
carlton	ㅋㅏㄹㅌㅓㄴ
conan	ㅋㅗㄴㅓㄴ
berryman	ㅂㅔㄹㅣㅁㅓㄴ
abdou	ㅇㅏㅂㄷㅜ
jade	ㅈㅔㅇㅣㄷㅡ
nash	ㄴㅐㅅㅣ
baby	ㅂㅔㅇㅣㅂㅣ
lone	ㄹㅗㄴㅔ
odonoghue	ㅇㅗㄷㅗㄴㅗㅎㅠ
jenkins	ㅈㅔㅇㅋㅣㄴㅅㅡ
lemon	ㄹㅔㅁㅗㄴ
adamson	ㅇㅐㄷㅓㅁㅅㅡㄴ
galle	ㄱㅏㄹㄹㅔ
aden	ㅇㅏㄷㅔㄴ
celentano	ㅊㅔㄹㄹㅔㄴㅌㅏㄴㅗ
bam	ㅂㅏㅁ
cheung	ㅊㅓㅇ
teixeira	ㅌㅔㅇㅣㅅㅖㅇㅣㄹㅏ
pennington	ㅍㅔㄴㅣㅇㅌㅓㄴ
kam	ㅋㅏㅁ
yasuchika	ㅇㅑㅅㅡㅊㅣㅋㅏ
nat	ㄴㅐㅅ
elvin	ㅇㅔㄹㅂㅣㄴ
klose	ㅋㅡㄹㄹㅗㅈㅔ
neville	ㄴㅔㅂㅣㄹ
fridman	ㅍㅡㄹㅣㄷㅡㅁㅏㄴ
kalevi	ㅋㅏㄹㄹㅔㅂㅣ
zain	ㅈㅔㅇㅣㄴ
lotman	ㄹㅗㅌㅡㅁㅏㄴ
betti	ㅂㅔㅌㅣ
arnold	ㅇㅏㄴㅓㄹㄷㅡ
teena	ㅌㅣㄴㅏ
demosthenes	ㄷㅔㅁㅗㅅㅡㅌㅔㄴㅔㅅㅡ
yoshinori	ㅇㅛㅅㅣㄴㅗㄹㅣ
recep	ㄹㅔㅈㅔㅍㅡ
kira	ㅋㅣㄹㅏ
corentin	ㅋㅗㄹㅏㅇㅌㅐㅇ
tom	ㅌㅗㅁ
jurado	ㅎㅜㄹㅏㄷㅗ
belle	ㅂㅔㄹ
giorgi	ㄱㅣㅇㅗㄹㅡㄱㅣ
key	ㅋㅣ
elfman	ㅇㅔㄹㅍㅡㅁㅓㄴ
brenton	ㅂㅡㄹㅔㄴㅌㅓㄴ
hema	ㅎㅔㅁㅏ
biggs	ㅂㅣㄱㅡㅅㅡ
helms	ㅎㅔㄹㄹㅡㅁㅅㅡ
lancaster	ㄹㅐㅇㅋㅓㅅㅡㅌㅓ
guglielmo	ㄱㅜㄹㄹㅣㅇㅔㄹㅁㅗ
bueno	ㅂㅜㅇㅔㄴㅜ
kader	ㅋㅏㄷㅔㄹㅡ
hutton	ㅎㅓㅌㅓㄴ
royale	ㄱㅗㅇㅈㅜ
huntley	ㅎㅓㄴㅌㅡㄹㄹㅣ
le	ㄹㅡ
vickers	ㅂㅣㅋㅓㅅㅡ
amenemhat	ㅇㅏㅁㅔㄴㅔㅁㅎㅔㅌㅡ
byrne	ㅂㅓㄴ
dobson	ㄷㅗㅂㅅㅡㄴ
gotthold	ㄱㅗㅌㅡㅎㅗㄹㅌㅡ
carew	ㅋㅏㄹㅔㅂㅡ
nikolay	ㄴㅣㅋㅗㄹㄹㅏㅇㅣ
valverde	ㅂㅏㄹㅂㅔㄹㅡㄷㅔ
wallis	ㅇㅝㄹㄹㅣㅅㅡ
steve	ㅅㅡㅌㅣㅂㅡ
anders	ㅇㅏㄴㄷㅔㄹㅡㅅㅡ
moniz	ㅁㅗㄴㅣㅈㅡ
buddy	ㅂㅓㄷㅣ
snuka	ㅅㅡㄴㅜㅋㅏ
larson	ㄹㅏㅅㅡㄴ
clements	ㅋㅡㄹㄹㅔㅁㅔㄴㅊㅡ
abul	ㅇㅏㅂㅜㄹ
lamine	ㄹㅏㅁㅣㄴㅔ
elmore	ㅇㅔㄹㅁㅗㅇㅓ
lind	ㄹㅣㄴㄷㅡ
sheffield	ㅅㅖㅍㅣㄹㄷㅡ
madeline	ㅁㅐㄷㅡㄹㄹㅣㄴ
nadal	ㄴㅏㄷㅏㄹ
bertram	ㅂㅓㅌㅡㄹㅓㅁ
steponas	ㅅㅡㅌㅔㅍㅗㄴㅏㅅㅡ
ellison	ㅇㅔㄹㄹㅣㅅㅡㄴ
boone	ㅂㅜㄴ
hurd	ㅎㅓㄷㅡ
craven	ㅋㅡㄹㅔㅇㅣㅂㅡㄴ
anton	ㅇㅏㄴㅌㅗㄴ
ambani	ㅇㅏㅁㅂㅏㄴㅣ
margo	ㅁㅏㄱㅗ
alves	ㅇㅏㅇㅜㅂㅔㅅㅡ
nguema	ㅇㅡㅇㄱㅔㅁㅏ
zaha	ㅈㅏㅎㅏ
branco	ㅂㅡㄹㅏㅇㅋㅜ
warrior	ㅇㅝㄹㅣㅇㅓ
lucas	ㄹㅜㅋㅏㅅㅡ
godunov	ㄱㅗㄷㅜㄴㅗㅍㅡ
purcell	ㅍㅓㅅㅔㄹ
abby	ㅇㅐㅂㅣ
hans	ㅎㅏㄴㅅㅡ
doug	ㄷㅓㄱㅡ
gennaro	ㅈㅔㄴㄴㅏㄹㅗ
goode	ㄱㅜㄷㅡ
carmack	ㅋㅏㅁㅐㄱ
aliyeva	ㅇㅏㄹㄹㅣㅇㅖㅂㅏ
gentile	ㅈㅔㄴㅌㅣㄹㄹㅔ
rajesh	ㄹㅏㅈㅔㅅㅣ
leone	ㄹㅔㅇㅗㄴㅔ
mccormick	ㅁㅐㅋㅗㅁㅣㄱ
stephan	ㅅㅠㅌㅔㅍㅏㄴ
alexi	ㅇㅏㄹㄹㅔㄱㅅㅣ
howard	ㅎㅏㅇㅝㄷㅡ
overmars	ㅇㅗㅂㅓㄹㅡㅁㅏㄹㅡㅅㅡ
lydia	ㄹㅣㄷㅣㅇㅏ
korzeniowski	ㅋㅗㅈㅔㄴㅣㅇㅗㅍㅡㅅㅡㅋㅣ
anwar	ㅇㅏㄴㅇㅘㄹㅡ
watt	ㅇㅘㅌㅡ
goldsmith	ㄱㅗㄹㄷㅡㅅㅡㅁㅣㅅㅡ
boleyn	ㅂㅜㄹㄹㅣㄴ
weller	ㅇㅞㄹㄹㅓ
edi	ㅇㅔㄷㅣ
todt	ㅌㅗㅌㅡ
zdravko	ㅈㅡㄷㅡㄹㅏㅂㅡㅋㅗ
alessio	ㅇㅏㄹㄹㅔㅅㅣㅇㅗ
gutenberg	ㄱㅜㅌㅔㄴㅂㅔㄹㅡㅋㅡ
volodin	ㅂㅗㄹㄹㅗㄷㅣㄴ
duvall	ㄷㅠㅂㅏㄹ
tamura	ㄷㅏㅁㅜㄹㅏ
bella	ㅂㅔㄹㄹㅏ
georgios	ㅇㅛㄹㅡㅇㅛㅅㅡ
gracie	ㄱㅡㄹㅔㅇㅣㅅㅣ
ozuna	ㅇㅗㅈㅡㄴㅏ
ally	ㅇㅐㄹㄹㅣ
palaiologos	ㅍㅏㄹㄹㅏㅇㅣㅇㅗㄹㄹㅗㄱㅗㅅㅡ
solimena	ㅅㅗㄹㄹㅣㅁㅔㄴㅏ
julieta	ㅎㅜㄹㄹㅣㅇㅔㅌㅏ
berti	ㅂㅔㄹㅡㅌㅣ
yamada	ㅇㅑㅁㅏㄷㅏ
dangelo	ㄷㅣㅇㅐㄴㅈㅓㄹㄹㅗ
ullmann	ㅇㅜㄹㅁㅏㄴ
bainbridge	ㅂㅔㅇㅣㄴㅂㅡㄹㅣㅈㅣ
clementi	ㅋㅡㄹㄹㅔㅁㅔㄴㅌㅣ
lyle	ㄹㅏㅇㅣㄹ
scholes	ㅅㅡㅋㅗㄹㅅㅡ
merino	ㅁㅔㄹㅣㄴㅗ
cao	ㅈㅗ
coenus	ㅋㅗㅇㅣㄴㅗㅅㅡ
nozomi	ㅅㅏㅅㅏㅋㅣ
moriarty	ㅁㅗㄹㅣㅇㅏㅌㅣ
peyton	ㅍㅔㅇㅣㅌㅓㄴ
henderson	ㅎㅔㄴㄷㅓㅅㅡㄴ
mccord	ㅁㅐㅋㅗㄷㅡ
allen	ㅇㅐㄹㄹㅓㄴ
maddie	ㅁㅐㄷㅣ
cornelius	ㅋㅗㄹㅡㄴㅔㄹㄹㅣㅇㅜㅅㅡ
souza	ㅅㅗㅈㅏ
kang	ㄱㅏㅇ
pryce	ㅍㅡㄹㅏㅇㅣㅅㅡ
barrios	ㅂㅏㄹㅣㅇㅗㅅㅡ
kawamura	ㄱㅏㅇㅘㅁㅜㄹㅏ
grimm	ㄱㅡㄹㅣㅁ
adil	ㅇㅏㄷㅣㄹ
florent	ㅍㅡㄹㄹㅗㄹㅏㅇ
flavia	ㅍㅡㄹㄹㅏㅂㅣㅇㅏ
arteta	ㅇㅏㄹㅡㅌㅔㅌㅏ
murdock	ㅁㅓㄷㅗㄱ
huey	ㅎㅠㅇㅣ
dion	ㄷㅣㅇㅗㅇ
humberto	ㅇㅜㅁㅂㅔㄹㅡㅌㅗ
wilkins	ㅇㅟㄹㅋㅣㄴㅅㅡ
ramsey	ㄹㅐㅁㅈㅣ
fabio	ㅍㅏㅂㅣㅇㅗ
master	ㅁㅏㅅㅡㅌㅓ
goya	ㄱㅗㅇㅑ
schweinsteiger	ㅅㅠㅂㅏㅇㅣㄴㅅㅠㅌㅏㅇㅣㄱㅓ
yusof	ㅇㅠㅅㅗㅍㅡ
tsutsui	ㅆㅡㅆㅡㅇㅣ
xander	ㅈㅐㄴㄷㅓ
castelnuovo	ㅋㅏㅅㅡㅌㅔㄹㄴㅜㅇㅗㅂㅗ
takatsugu	ㄷㅏㅋㅏㅆㅡㄱㅜ
oskari	ㅇㅗㅅㅡㅋㅏㄹㅣ
carla	ㅋㅏㄹㅡㄹㄹㅏ
marek	ㅁㅏㄹㅔㅋㅡ
agata	ㅇㅏㄱㅏㅌㅏ
rivaldo	ㅎㅣㅂㅏㅇㅜㄷㅜ
baba	ㅂㅏㅂㅏ
tore	ㅌㅗㄹㅔ
sherry	ㅅㅖㄹㅣ
welch	ㅇㅞㄹㅊㅣ
paes	ㅍㅏㅇㅣㅅㅡ
conti	ㅋㅗㄴㅌㅣ
rudolf	ㄹㅜㄷㅗㄹㅍㅡ
cedric	ㅅㅔㄷㅡㄹㅣㄱ
valenzuela	ㅂㅏㄹㄹㅔㄴㅅㅜㅇㅔㄹㄹㅏ
milito	ㅁㅣㄹㄹㅣㅌㅗ
bela	ㅂㅔㄹㄹㅏ
kirchner	ㅋㅣㄹㅡㅎㅣㄴㅓ
vanderlei	ㅂㅏㄴㄷㅔㄹㅡㄹㄹㅔㅇㅣ
mirai	ㅁㅣㄹㅏㅇㅣ
levitt	ㄹㅔㅂㅣㅅ
bas	ㅂㅏㅅㅡ
stella	ㅅㅡㅌㅔㄹㄹㅏ
mario	ㅁㅏㄹㅣㅇㅗ
kenichi	ㅋㅔㄴㅇㅣㅊㅣ
vladimir	ㅂㅡㄹㄹㅏㄷㅣㅁㅣㄹㅡ
eisenstein	ㅇㅏㅇㅣㅈㅔㄴㅅㅠㅌㅏㅇㅣㄴ
boyce	ㅂㅗㅇㅣㅅㅡ
latasha	ㄹㅏㅌㅏㅅㅑ
luigi	ㄹㅜㅇㅣㅈㅣ
paxton	ㅍㅐㄱㅅㅡㅌㅓㄴ
heaton	ㅎㅣㅌㅓㄴ
olaf	ㅇㅗㄹㄹㅏㅍㅡ
do	ㄷㅜ
lynne	ㄹㅣㄴ
kaur	ㅋㅏㅇㅜㄹㅡ
selim	ㅅㅔㄹㄹㅣㅁ
thelma	ㅅㅔㄹㅁㅏ
carl	ㅋㅏㄹㅡㄹ
alfaro	ㅇㅏㄹㅍㅏㄹㅗ
aja	ㅇㅏㅈㅏ
giuliano	ㅈㅜㄹㄹㅣㅇㅏㄴㅗ
friedmann	ㅍㅡㄹㅣㄷㅡㅁㅏㄴ
rossy	ㄹㅗㅅㅣ
venier	ㅂㅔㄴㅣㅇㅔㄹㅡ
katsumoto	ㄱㅏㅆㅡㅁㅗㅌㅗ
youri	ㅇㅠㄹㅣ
dibiase	ㄷㅣㅂㅣㅇㅏㅅㅣ
gabrielle	ㄱㅐㅂㅡㄹㅣㅇㅔㄹ
naomi	ㄴㅏㅇㅗㅁㅣ
yoshihisa	ㅇㅛㅅㅣㅎㅣㅅㅏ
hachisuka	ㅎㅏㅊㅣㅅㅡㅋㅏ
alicia	ㅇㅓㄹㄹㅣㅅㅑ
sherif	ㅅㅑㄹㅣㅍㅡ
majidi	ㅁㅏㅈㅣㄷㅣ
huerta	ㅇㅜㅇㅔㄹㅡㅌㅏ
mcfadden	ㅁㅐㄱㅍㅐㄷㅡㄴ
marini	ㅁㅏㄹㅣㄴㅣ
pearce	ㅍㅣㅇㅓㅅㅡ
bilodeau	ㅂㅣㄹㄹㅗㄷㅗ
molinaro	ㅁㅗㄹㄹㅣㄴㅏㄹㅗ
robles	ㄹㅗㅂㅡㄹㄹㅔㅅㅡ
haji	ㅎㅏㅈㅣ
olson	ㅇㅗㄹㅅㅡㄴ
pechstein	ㅍㅔㅎㅣㅅㅠㅌㅏㅇㅣㄴ
thompson	ㅌㅗㅁㅍㅡㅅㅡㄴ
nathaniel	ㄴㅓㅅㅐㄴㅣㅇㅓㄹ
brandt	ㅂㅡㄹㅏㄴㅌㅡ
bhatt	ㅂㅏㅌㅡ
montgomery	ㅁㅗㅇㄱㅗㅁㅔㄹㅣ
hassler	ㅎㅏㅅㅡㄹㄹㅓ
leoni	ㄹㅔㅇㅗㄴㅣ
ebbe	ㅇㅔㅂㅔ
nathalie	ㄴㅏㅌㅏㄹㄹㅣ
kaufmann	ㅋㅏㅇㅜㅍㅡㅁㅏㄴ
fabrice	ㅍㅏㅂㅡㄹㅣㅅㅡ
raza	ㄹㅏㅈㅏ
kardashian	ㅋㅏㄷㅏㅅㅣㅇㅏㄴ
bartram	ㅂㅏㄹㅡㅌㅡㄹㅏㅁ
joyce	ㅈㅗㅇㅣㅅㅡ
atta	ㅇㅏㅌㅏ
pinheiro	ㅍㅣㄴㅖㅇㅣㄹㅜ
rovere	ㄹㅗㅂㅔㄹㅔ
gordian	ㄱㅗㄹㅡㄷㅣㅇㅏㄴㅜㅅㅡ
sherman	ㅅㅕㅁㅓㄴ
hamelin	ㅇㅏㅁㅡㄹㄹㅐㅇ
mari	ㅁㅏㄹㅣ
bowe	ㅂㅗ
hebb	ㅎㅔㅂㅡ
coveleski	ㅋㅗㅂㅔㄹㄹㅔㅅㅡㅋㅣ
lamb	ㄹㅐㅁ
perlman	ㅍㅓㄹㅁㅓㄴ
ianis	ㅇㅣㅇㅏㄴㅣㅅㅡ
donatas	ㄷㅗㄴㅏㅌㅏㅅㅡ
carrara	ㅋㅏㄹㅏㄹㅏ
aria	ㅇㅏㄹㅣㅇㅏ
shue	ㅅㅠ
yohan	ㅇㅛㅎㅏㄴ
shiri	ㅅㅣㄹㅣ
mikael	ㅁㅣㅋㅏㅇㅔㄹ
masatsune	ㅁㅏㅅㅏㅆㅡㄴㅔ
wiles	ㅇㅘㅇㅣㄹㅅㅡ
delany	ㄷㅣㄹㄹㅔㅇㅣㄴㅣ
artatama	ㅇㅏㄹㅡㅌㅏㅁㅏㅁㅏ
barbara	ㅂㅏㅂㅓㄹㅏ
kiki	ㅋㅣㅋㅣ
alexander	ㅇㅏㄹㄹㅔㄱㅅㅏㄴㄷㅓ
higgins	ㅎㅣㄱㅣㄴㅅㅡ
tara	ㅌㅏㄹㅏ
grey	ㄱㅡㄹㅔㅇㅣ
francois	ㅍㅡㄹㅏㅇㅅㅜㅇㅏ
el	ㅇㅔㄹ
carole	ㅋㅏㄹㅗㄹ
battle	ㅂㅐㅌㅡㄹ
vik	ㅂㅣㄱ
madrid	ㅁㅏㄷㅡㄹㅣㄷㅡ
scott	ㅅㅡㅋㅗㅅ
kevin	ㅋㅔㅂㅣㄴ
wimmer	ㅂㅣㅁㅓ
curie	ㅋㅟㄹㅣ
hornsby	ㅎㅗㄴㅈㅡㅂㅣ
goldner	ㄱㅗㄹㄷㅡㄴㅓ
jebb	ㅈㅔㅂ
swan	ㅅㅡㅇㅘㄴ
caballero	ㅋㅏㅂㅏㅇㅖㄹㅗ
mai	ㅁㅏㅇㅣ
trine	ㅌㅡㄹㅣㄴㅔ
clint	ㅋㅡㄹㄹㅣㄴㅌㅡ
cline	ㅋㅡㄹㄹㅏㅇㅣㄴ
mancini	ㅁㅐㄴㅅㅣㄴㅣ
mokoena	ㅁㅗㅋㅗㅇㅔㄴㅏ
longoria	ㄹㅗㅇㄱㅗㄹㅣㅇㅏ
florian	ㅍㅡㄹㄹㅗㄹㅣㅇㅏㄴ
moritz	ㅁㅗㄹㅣㅊㅡ
malin	ㅁㅏㄹㄹㅣㄴ
lysenko	ㄹㅣㅅㅔㄴㅋㅗ
evigan	ㅇㅔㅂㅣㄱㅓㄴ
yuriy	ㅇㅠㄹㅣ
moran	ㅁㅗㄹㅏㄴ
trajkovski	ㅌㅡㄹㅏㅇㅣㅋㅗㅍㅡㅅㅡㅋㅣ
melvin	ㅁㅔㄹㅂㅣㄴ
bill	ㅂㅣㄹ
yoshihiro	ㅇㅛㅅㅣㅎㅣㄹㅗ
glass	ㄱㅡㄹㄹㅐㅅㅡ
jonah	ㅈㅗㄴㅏ
tammi	ㅌㅏㅁㅣ
kornelia	ㅋㅗㄹㅡㄴㅔㄹㄹㅣㅇㅏ
phillips	ㅍㅣㄹㄹㅣㅂㅅㅡ
nobukatsu	ㄴㅗㅂㅜㅋㅏㅆㅡ
hodge	ㅎㅗㅈㅣ
volta	ㅂㅗㄹㅌㅏ
oneal	ㅇㅗㄴㅣㄹ
adriana	ㅇㅏㄷㅡㄹㅣㅇㅏㄴㅏ
franz	ㅍㅡㄹㅏㄴㅊㅡ
patty	ㅍㅐㅌㅣ
amado	ㅇㅏㅁㅏㄷㅜ
yoshida	ㅇㅛㅅㅣㄷㅏ
satake	ㅅㅏㅌㅏㅋㅔ
polina	ㅍㅗㄹㄹㅣㄴㅏ
dolan	ㄷㅗㄹㄹㅏㄴ
sweeney	ㅅㅡㅇㅟㄴㅣ
juninho	ㅈㅜㄴㅣㄴㅠ
grigore	ㄱㅡㄹㅣㄱㅗㄹㅔ
pinilla	ㅍㅣㄴㅣㅇㅑ
black	ㅂㅡㄹㄹㅐㄱ
ogden	ㅇㅗㄱㅡㄷㅓㄴ
saunders	ㅅㅗㄴㄷㅓㅅㅡ
zazie	ㅈㅏㅈㅣ
dabo	ㄷㅏㅂㅗ
grosso	ㄱㅡㄹㅗㅅㅗ
eudokia	ㅇㅔㅇㅜㄷㅗㅋㅣㅇㅏ
priyanka	ㅍㅡㄹㅣㅇㅑㅇㅋㅏ
collin	ㅋㅗㄹㄹㅣㄴ
flavio	ㅍㅡㄹㄹㅏㅂㅣㅇㅗ
jodorowsky	ㅎㅗㄷㅗㄹㅗㅍㅡㅅㅡㅋㅣ
chip	ㅊㅣㅂ
jordon	ㅈㅗㄷㅓㄴ
roderick	ㄹㅗㄷㅓㄹㅣㄱ
sepp	ㅈㅔㅍㅡ
big	ㅂㅣㄱ
suleiman	ㅅㅜㄹㄹㅔㅇㅣㅁㅏㄴ
privalova	ㅍㅡㄹㅣㅂㅏㄹㄹㅗㅂㅏ
abdallah	ㅇㅏㅂㄷㅏㄹㄹㅏ
sargsyan	ㅅㅏㄹㅡㄱㅡㅅㅑㄴ
pearl	ㅍㅓㄹ
tran	ㅌㅡㄹㅏㄴ
beatrix	ㅂㅔㅇㅏㅌㅡㄹㅣㄱㅅㅡ
hillel	ㅎㅣㄹㄹㅔㄹ
urvashi	ㅇㅜㄹㅡㅂㅏㅅㅣ
cuenca	ㅋㅜㅇㅔㅇㅋㅏ
camillo	ㅋㅏㅁㅣㄹㄹㅗ
lola	ㄹㅗㄹㄹㅏ
krystyna	ㅋㅡㄹㅣㅅㅡㅌㅣㄴㅏ
yura	ㅇㅠㄹㅏ
hernandez	ㅇㅔㄹㅡㄴㅏㄴㄷㅔㅅㅡ
fulton	ㅍㅜㄹㅌㅓㄴ
dolores	ㄷㅗㄹㄹㅗㄹㅔㅅㅡ
kieran	ㅋㅣㄹㅓㄴ
piper	ㅍㅏㅇㅣㅍㅓ
ponte	ㅍㅗㄴㅌㅔ
stefani	ㅅㅡㅌㅔㅍㅏㄴㅣ
sten	ㅅㅡㅌㅔㄴ
conchita	ㅋㅗㄴㅊㅣㅌㅏ
wayne	ㅇㅞㅇㅣㄴ
boaz	ㅂㅗㅇㅏㅈㅡ
manteuffel	ㅁㅏㄴㅌㅗㅇㅣㅍㅔㄹ
gus	ㄱㅓㅅㅡ
yael	ㅇㅑㅇㅔㄹ
andreou	ㅇㅏㄴㄷㅡㄹㅔㅇㅜ
takuya	ㅁㅣㅇㅑㅁㅗㅌㅗ
johansen	ㅇㅛㅎㅏㄴㅅㅔㄴ
shigenao	ㅅㅣㄱㅔㄴㅏㅇㅗ
hooper	ㅎㅜㅍㅓ
craig	ㅋㅡㄹㅔㅇㅣㄱㅡ
galeazzo	ㄱㅏㄹㄹㅔㅇㅏㅊㅗ
reyes	ㄹㅔㅇㅖㅅㅡ
hugo	ㅎㅜㄱㅗ
payne	ㅍㅔㅇㅣㄴ
philip	ㅍㅣㄹㄹㅣㅂ
ozan	ㅇㅗㅈㅏㄴ
min	ㅁㅣㄴ
chandragupta	ㅊㅏㄴㄷㅡㄹㅏㄱㅜㅂㅌㅏ
minghella	ㅁㅣㅇㄱㅔㄹㄹㅏ
della	ㄷㅔㄹㄹㅏ
dmytro	ㄷㅡㅁㅣㅌㅡㄹㅗ
matti	ㅁㅏㅌㅣ
juris	ㅇㅠㄹㅣㅅㅡ
walters	ㅇㅝㄹㅌㅓㅅㅡ
rath	ㄹㅐㅅㅡ
gonzaga	ㄱㅗㄴㅊㅏㄱㅏ
linder	ㄹㅣㄴㄷㅔㄹㅡ
tadahiro	ㄷㅏㄷㅏㅎㅣㄹㅗ
pullman	ㅍㅜㄹㅁㅓㄴ
germaine	ㅈㅓㅁㅔㅇㅣㄴ
prince	ㅍㅡㄹㅣㄴㅅㅡ
vitaliy	ㅂㅣㅌㅏㄹㄹㅣ
shikibu	ㅅㅣㅋㅣㅂㅜ
giannini	ㅈㅏㄴㄴㅣㄴㅣ
ike	ㅇㅏㅇㅣㅋㅡ
yoshitoshi	ㅇㅛㅅㅣㅌㅗㅅㅣ
mursili	ㅁㅜㄹㅡㅅㅣㄹㄹㅣ
marjorie	ㅁㅏㅈㅓㄹㅣ
antanas	ㅇㅏㄴㅌㅏㄴㅏㅅㅡ
one	ㅇㅝㄴ
angus	ㅇㅐㅇㄱㅓㅅㅡ
bohringer	ㅂㅗㄹㅐㅇㅈㅔ
laura	ㄹㅗㄹㅏ
mantegna	ㅁㅏㄴㅌㅔㄴㅑ
glebova	ㄱㅡㄹㄹㅔㅂㅗㅂㅏ
yvonne	ㅇㅣㅂㅗㄴ
millar	ㅁㅣㄹㄹㅓ
matsura	ㅁㅏㅊㅡㄹㅏ
kittel	ㅋㅣㅌㅔㄹ
dale	ㄷㅔㅇㅣㄹ
jr	ㅈㅜㄴㅣㅇㅓ
jacinda	ㅈㅐㅅㅣㄴㄷㅏ
u	ㅇㅜ
akram	ㅇㅏㅋㅡㄹㅏㅁ
win	ㅇㅟㄴ
spencer	ㅅㅡㅍㅔㄴㅅㅓ
ilona	ㅇㅣㄹㄹㅗㄴㅏ
ugo	ㅇㅜㄱㅗ
ngozi	ㅇㅡㅇㄱㅗㅈㅣ
popp	ㅍㅗㅍㅡ
boubacar	ㅂㅜㅂㅏㅋㅏㄹㅡ
waris	ㅇㅘㄹㅣㅅㅡ
miles	ㅁㅏㅇㅣㄹㅅㅡ
goldstein	ㄱㅗㄹㄷㅡㅅㅡㅌㅏㅇㅣㄴ
hakeem	ㅎㅏㅋㅣㅁ
nicolai	ㄴㅣㅋㅗㄹㄹㅏㅇㅣ
graeme	ㄱㅡㄹㅔㅇㅣㅁ
timur	ㅌㅣㅁㅜㄹㅡ
ichiro	ㅅㅡㅈㅡㅋㅣ
walsh	ㅇㅝㄹㅅㅣ
lindstrom	ㄹㅣㄴㄷㅡㅅㅡㅌㅗㅁ
josiah	ㅈㅗㅅㅏㅇㅣㅇㅓ
claude	ㅋㅡㄹㄹㅗㄷㅡ
moraes	ㅁㅗㄹㅏㅇㅣㅅㅡ
griffith	ㄱㅡㄹㅣㅍㅣㅅㅡ
libertad	ㄹㅣㅂㅔㄹㅡㅌㅏㄷㅡ
beth	ㅂㅔㅅㅡ
bryan	ㅂㅡㄹㅏㅇㅣㅇㅓㄴ
sonny	ㅅㅗㄴㅣ
ros	ㄹㅗㅅㅡ
esti	ㅇㅔㅅㅡㅌㅣ
moore	ㅁㅜㅇㅓ
forde	ㅍㅗㄷㅡ
norwood	ㄴㅗㅇㅜㄷㅡ
sunny	ㅅㅓㄴㅣ
lazarev	ㄹㅏㅈㅏㄹㅔㅍㅡ
jardel	ㅈㅏㄹㅡㄷㅔㅇㅜ
ventura	ㅂㅔㄴㅌㅜㄹㅏ
caselli	ㅋㅏㅅㅔㄹㄹㅣ
stockdale	ㅅㅡㅌㅗㄱㄷㅔㅇㅣㄹ
jane	ㅈㅔㅇㅣㄴ
bosch	ㅂㅗㅅㅠ
samedov	ㅅㅏㅁㅔㄷㅗㅍㅡ
noguchi	ㄴㅗㄱㅜㅊㅣ
mutsumi	ㅅㅏㅅㅏㅋㅣ
woods	ㅇㅜㅈㅡ
hari	ㅎㅏㄹㅣ
tadatsune	ㄷㅏㄷㅏㅆㅡㄴㅔ
granados	ㄱㅡㄹㅏㄴㅏㄷㅗㅅㅡ
telles	ㅌㅔㄹㄹㅔㅅㅡ
poulsen	ㅍㅗㅇㅜㄹㅅㅔㄴ
clay	ㅋㅡㄹㄹㅔㅇㅣ
major	ㅁㅔㅇㅣㅈㅓ
gallas	ㄱㅏㄹㄹㅏㅅㅡ
karine	ㅋㅏㄹㅣㄴ
floyd	ㅍㅡㄹㄹㅗㅇㅣㄷㅡ
berni	ㅂㅔㄹㅡㄴㅣ
maeda	ㅁㅏㅇㅔㄷㅏ
davenport	ㄷㅐㅂㅡㄴㅍㅗㅌㅡ
bernd	ㅂㅔㄹㅡㄴㅌㅡ
antoni	ㅇㅏㄴㅌㅗㄴㅣ
anaya	ㅇㅏㄴㅏㅇㅑ
brock	ㅂㅡㄹㅗㄱ
josep	ㅈㅗㅈㅔㅍㅡ
campbell	ㅋㅐㅁㅂㅔㄹ
vesna	ㅂㅔㅅㅡㄴㅏ
teresa	ㅌㅔㄹㅔㅅㅏ
jasmin	ㅇㅑㅅㅡㅁㅣㄴ
nestor	ㄴㅔㅅㅡㅌㅗㄹㅡ
wendy	ㅇㅞㄴㄷㅣ
bowie	ㅂㅗㅇㅟ
mcdermott	ㅁㅐㄱㄷㅓㅁㅗㅌㅡ
davies	ㄷㅔㅇㅣㅂㅣㅅㅡ
sabatini	ㅅㅏㅂㅏㅌㅣㄴㅣ
alvarado	ㅇㅏㄹㅂㅏㄹㅏㄷㅗ
turner	ㅌㅓㄴㅓ
rawls	ㄹㅗㄹㅅㅡ
andrzej	ㅇㅏㄴㅈㅔㅇㅣ
dionysios	ㄷㅣㅇㅗㄴㅣㅅㅣㅇㅗㅅㅡ
nobuhide	ㄴㅗㅂㅜㅎㅣㄷㅔ
henson	ㅎㅔㄴㅅㅡㄴ
octavio	ㅇㅗㄱㅌㅏㅂㅣㅇㅗ
hicks	ㅎㅣㄱㅅㅡ
dahl	ㄷㅏㄹ
priestley	ㅍㅡㄹㅣㅅㅡㅌㅡㄹㄹㅣ
raymond	ㄹㅔㅇㅣㅁㅓㄴㄷㅡ
jankell	ㅇㅑㅇㅋㅔㄹ
humperdinck	ㅎㅜㅁㅍㅓㄷㅣㅇㅋㅡ
tupper	ㅌㅓㅍㅓ
marija	ㅁㅏㄹㅣㅇㅑ
safina	ㅅㅏㅍㅣㄴㅏ
paige	ㅍㅔㅇㅣㅈㅣ
rafferty	ㄹㅐㅍㅓㅌㅣ
gozen	ㄱㅗㅈㅔㄴ
perrineau	ㅍㅔㄹㅣㄴㅗ
espectrito	ㅇㅔㅅㅡㅍㅔㄱㅌㅡㄹㅣㅌㅗ
strasberg	ㅅㅡㅌㅡㄹㅐㅅㅡㅂㅓㄱㅡ
beg	ㅋㅏㄴ
aleksandrs	ㅇㅏㄹㄹㅔㄱㅅㅏㄴㄷㅡㄹㅡㅅㅡ
alexis	ㅇㅏㄹㄹㅔㄱㅅㅣㅅㅡ
winkleman	ㅇㅟㄴㅋㅡㄹㅁㅏㄴ
lipton	ㄹㅣㅂㅌㅓㄴ
jennie	ㅈㅔㄴㅣ
drake	ㄷㅡㄹㅔㅇㅣㅋㅡ
candy	ㅋㅐㄴㄷㅣ
glenister	ㄱㅡㄹㄹㅔㄴㅣㅅㅡㅌㅓ
calvi	ㅋㅏㄹㅂㅣ
inaba	ㅇㅣㄴㅏㅂㅏ
ada	ㅇㅏㄷㅏ
cardinale	ㅋㅏㄹㅡㄷㅣㄴㅏㄹㄹㅔ
trisha	ㅌㅡㄹㅣㅅㅑ
ethel	ㅇㅔㅅㅓㄹ
aloysius	ㅇㅏㄹㄹㅗㅇㅣㅅㅣㅇㅗ
emilie	ㅇㅔㅁㅣㄹㄹㅣ
stahl	ㅅㅡㅌㅏㄹ
amer	ㅇㅏㅁㅔㄹㅡ
cristoforo	ㅋㅡㄹㅣㅅㅡㅌㅗㅍㅗㄹㅗ
hodler	ㅎㅗㄷㅡㄹㄹㅓ
shostakovich	ㅅㅛㅅㅡㅌㅏㅋㅗㅂㅣㅊㅣ
valeriy	ㅂㅏㄹㄹㅔㄹㅣ
salma	ㅅㅏㄹㅁㅏ
gennady	ㄱㅔㄴㄴㅏㄷㅣ
vega	ㅂㅔㄱㅏ
dane	ㄷㅔㅇㅣㄴ
kiran	ㅋㅣㄹㅏㄴ
song	ㅅㅗㅇ
kellie	ㅋㅔㄹㄹㅣ
ruiz	ㄹㅜㅇㅣㅅㅡ
watts	ㅇㅘㅊㅡ
albanese	ㅇㅏㄹㅂㅏㄴㅔㅅㅔ
jimi	ㅈㅣㅁㅣ
tedeschi	ㅌㅔㄷㅔㅅㅡㅋㅣ
fennell	ㅍㅔㄴㅔㄹ
amrita	ㅇㅏㅁㄹㅣㅌㅏ
tigran	ㅌㅣㄱㅡㄹㅏㄴ
sharp	ㅅㅑㅍㅡ
gaye	ㄱㅔㅇㅣ
maribel	ㅁㅏㄹㅣㅂㅔㄹ
fishman	ㅍㅣㅅㅣㅁㅓㄴ
pertwee	ㅍㅓㅌㅡㅇㅟ
younis	ㅇㅠㄴㅣㅅㅡ
winston	ㅇㅟㄴㅅㅡㅌㅓㄴ
demi	ㄷㅔㅁㅣ
y	ㅇㅣ
annibale	ㅇㅏㄴㄴㅣㅂㅏㄹㄹㅔ
mal	ㅁㅐㄹ
husayn	ㅎㅜㅅㅏㅇㅣㄴ
olly	ㅇㅗㄹㄹㅣ
carrillo	ㅋㅏㄹㅣㅇㅛ
zimbalist	ㅈㅣㅁㅂㅏㄹㄹㅣㅅㅡㅌㅡ
duckworth	ㄷㅓㅋㅡㅇㅝㅅㅡ
abdirashid	ㅇㅏㅂㄷㅣㄹㅏㅅㅣㄷㅡ
grimani	ㄱㅡㄹㅣㅁㅏㄴㅣ
mendy	ㅁㅔㄴㄷㅣ
norma	ㄴㅗㅁㅏ
moyes	ㅁㅗㅇㅖㅅㅡ
victor	ㅂㅣㄱㅌㅗㄹㅡ
neurath	ㄴㅗㅇㅣㄹㅏㅌㅡ
goodwin	ㄱㅜㅅㅇㅟㄴ
wassermann	ㅂㅏㅅㅓㅁㅏㄴ
matej	ㅁㅏㅌㅔㅇㅣ
gillian	ㅈㅣㄹㄹㅣㅇㅓㄴ
thayer	ㅅㅔㅇㅣㅇㅓ
loy	ㄹㅗㅇㅣ
tracee	ㅌㅡㄹㅔㅇㅣㅅㅣ
zygmunt	ㅈㅣㄱㅡㅁㅜㄴㅌㅡ
trace	ㅌㅡㄹㅔㅇㅣㅅㅡ
rosie	ㄹㅗㅈㅣ
apa	ㅇㅏㅍㅏ
cave	ㅋㅔㅇㅣㅂㅡ
vlad	ㅂㅡㄹㄹㅏㄷㅡ
adnan	ㅇㅏㄷㅡㄴㅏㄴ
warburton	ㅇㅝㅂㅓㅌㅓㄴ
sisowath	ㅅㅣㅅㅗㅇㅘㅅㅡ
sammi	ㅅㅐㅁㅣ
sissoko	ㅅㅣㅅㅗㅋㅗ
sargent	ㅅㅏㅈㅓㄴㅌㅡ
kraft	ㅋㅡㄹㅐㅍㅡㅌㅡ
devine	ㄷㅓㅂㅏㅇㅣㄴ
nicolas	ㄴㅣㅋㅗㄹㄹㅏ
curran	ㅋㅓㄹㅓㄴ
wahlgren	ㅂㅏㄹㄱㅡㄹㅔㄴ
marsha	ㅁㅏㅅㅑ
heyman	ㅎㅔㅇㅣㅁㅓㄴ
goldin	ㄱㅗㄹㄷㅣㄴ
munro	ㅁㅓㄴㄹㅗ
fonda	ㅍㅗㄴㄷㅏ
agnieszka	ㅇㅏㄱㅡㄴㅣㅇㅔㅅㅠㅋㅏ
petras	ㅍㅔㅌㅡㄹㅏㅅㅡ
gashi	ㄱㅏㅅㅣ
willian	ㅇㅟㄹㄹㅣㅇㅏㅇ
eliot	ㅇㅔㄹㄹㅣㅇㅓㅅ
danai	ㄷㅏㄴㅏㅇㅣ
manuel	ㅁㅏㄴㅜㅇㅔㄹ
howie	ㅎㅏㅇㅟ
bastos	ㅂㅏㅅㅡㅌㅜㅅㅡ
zahn	ㅈㅏㄴ
hamidi	ㅎㅏㅁㅣㄷㅣ
sveinn	ㅅㅡㅂㅔㅇㅣㄴ
patsy	ㅍㅐㅅㅅㅣ
bojana	ㅂㅗㅇㅑㄴㅏ
nicomachus	ㄴㅣㅋㅗㅁㅏㅋㅗㅅㅡ
marcin	ㅁㅏㄹㅡㅊㅣㄴ
coltrane	ㅋㅗㄹㅌㅡㄹㅔㅇㅣㄴ
maksym	ㅁㅏㄱㅅㅣㅁ
yasunobu	ㅇㅑㅅㅡㄴㅗㅂㅜ
da	ㄷㅏ
ludwig	ㄹㅜㅌㅡㅂㅣㅎㅣ
armin	ㅇㅏㅁㅣㄴ
palermo	ㅍㅏㄹㄹㅔㄹㅡㅁㅗ
jared	ㅈㅐㄹㅓㄷㅡ
norrie	ㄴㅗㄹㅣ
garry	ㄱㅔㄹㅣ
mahler	ㅁㅏㄹㄹㅓ
intef	ㅇㅣㄴㅌㅔㅍㅡ
jodie	ㅈㅗㄷㅣ
cotton	ㅋㅗㅌㅡㄴ
maurice	ㅁㅗㄹㅣㅅㅡ
ferguson	ㅍㅓㄱㅓㅅㅡㄴ
burnside	ㅂㅓㄴㅅㅏㅇㅣㄷㅡ
tolentino	ㅌㅗㄹㄹㅔㄴㅌㅣㄴㅗ
dragan	ㄷㅡㄹㅏㄱㅏㄴ
matthew	ㅁㅐㅅㅠ
louisa	ㄹㅜㅇㅣㅈㅏ
solari	ㅅㅗㄹㄹㅏㄹㅣ
hanno	ㅎㅏㄴㄴㅗ
hitoshi	ㅅㅏㅅㅏㅋㅣ
tommi	ㅌㅗㅁㅁㅣ
sanborn	ㅅㅐㄴㅂㅗㄴ
hewish	ㅎㅠㅇㅣㅅㅣ
stuart	ㅅㅡㅌㅠㅇㅓㅌㅡ
jules	ㅈㅟㄹ
miko	ㅁㅣㅋㅗ
dunn	ㄷㅓㄴ
adolph	ㅇㅏㄷㅗㄹㅍㅡ
dimitrov	ㄷㅣㅁㅣㅌㅡㄹㅗㅍㅡ
yousafzai	ㅇㅠㅅㅏㅍㅡㅈㅏㅇㅣ
charlie	ㅊㅏㄹㄹㅣ
attalus	ㅇㅏㅌㅏㄹㄹㅗㅅㅡ
zahir	ㅈㅏㅎㅣㄹㅡ
tariq	ㅌㅏㄹㅣㅋㅡ
ramelow	ㄹㅏㅁㅔㄹㄹㅗㅍㅡ
benton	ㅂㅔㄴㅌㅓㄴ
terentius	ㅌㅔㄹㅔㄴㅌㅣㅇㅜㅅㅡ
virginie	ㅂㅣㄹㅡㅈㅣㄴㅣ
dorsey	ㄷㅗㅅㅣ
uragami	ㅇㅜㄹㅏㄱㅏㅁㅣ
hori	ㅎㅗㄹㅣ
hamza	ㅎㅏㅁㅈㅏ
angel	ㅇㅔㅇㅣㄴㅈㅓㄹ
andrei	ㅇㅏㄴㄷㅡㄹㅔㅇㅣ
fink	ㅍㅣㅇㅋㅡ
iwakura	ㅇㅣㅇㅘㅋㅜㄹㅏ
david	ㄷㅔㅇㅣㅂㅣㄷㅡ
burnett	ㅂㅓㄴㅔㅅ
lloyd	ㄹㅗㅇㅣㄷㅡ
whyte	ㅎㅘㅇㅣㅌㅡ
denny	ㄷㅔㄴㅣ
abbott	ㅇㅐㅂㅓㅅ
mani	ㅁㅏㄴㅣ
wax	ㅇㅘㄱㅅㅡ
haas	ㅎㅏㅅㅡ
kamiya	ㅇㅠㅇㅜ
knudsen	ㅋㅡㄴㅜㅅㅔㄴ
claudia	ㅋㅡㄹㄹㅏㅇㅜㄷㅣㅇㅏ
raita	ㄹㅠ
henrique	ㅇㅔㄴㄹㅣㅋㅔ
toomey	ㅌㅜㅁㅣ
obi	ㅇㅗㅂㅣ
castro	ㅋㅏㅅㅡㅌㅡㄹㅗ
yehenara	ㅇㅖㅎㅓㄴㅏㄹㅏ
loren	ㄹㅗㄹㅓㄴ
chao	ㅊㅏㅇㅗ
fatma	ㅍㅏㅌㅡㅁㅏ
lacey	ㄹㅔㅇㅣㅅㅣ
reddy	ㄹㅔㄷㅣ
bianca	ㅂㅣㅇㅏㅇㅋㅏ
yuta	ㅇㅠㅌㅏ
sobieski	ㅅㅗㅂㅣㅇㅔㅅㅡㅋㅣ
chester	ㅊㅔㅅㅡㅌㅓ
jim	ㅈㅣㅁ
fusco	ㅍㅜㅅㅡㅋㅗ
gudrun	ㄱㅜㄷㅡㄹㅜㄴ
monk	ㅁㅗㅇㅋㅡ
stanislav	ㅅㅡㅌㅏㄴㅣㅅㅡㄹㄹㅏㅍㅡ
child	ㅊㅏㅇㅣㄹㄷㅡ
moseley	ㅁㅗㅈㅡㄹㄹㅣ
eochu	ㅇㅗㅎㅜ
duggan	ㄷㅓㄱㅓㄴ
takeshi	ㅇㅘㅌㅏㄴㅏㅂㅔ
bocanegra	ㅂㅗㅋㅏㄴㅔㄱㅡㄹㅏ
maynard	ㅁㅔㅇㅣㄴㅓㄷㅡ
thrax	ㅌㅡㄹㅏㄱㅅㅡ
irakli	ㅇㅣㄹㅏㅋㅡㄹㄹㅣ
peterson	ㅍㅣㅌㅓㅅㅡㄴ
shelly	ㅅㅖㄹㄹㅣ
kagan	ㅋㅔㅇㅣㄱㅓㄴ
constans	ㅋㅗㄴㅅㅡㅌㅏㄴㅅㅡ
balthasar	ㅂㅏㄹㅌㅏㅈㅏㄹㅡ
chief	ㅊㅣㅍㅡ
marques	ㅁㅏㄹㅡㅋㅔㅅㅡ
barlow	ㅂㅏㄹㅗㅇㅜ
northrop	ㄴㅗㅅㅡㄹㅓㅂ
smiles	ㅅㅡㅁㅏㅇㅣㄹㅈㅡ
sachs	ㅈㅏㄱㅅㅡ
johnsen	ㅇㅛㄴㅅㅔㄴ
woodbridge	ㅇㅜㄷㅡㅂㅡㄹㅣㅈㅣ
jaime	ㅎㅏㅇㅣㅁㅔ
egon	ㅇㅔㄱㅗㄴ
huggins	ㅎㅓㄱㅣㄴㅅㅡ
lucescu	ㄹㅜㅊㅔㅅㅡㅋㅜ
heidi	ㅎㅏㅇㅣㄷㅣ
cervantes	ㅅㅔㄹㅡㅂㅏㄴㅌㅔㅅㅡ
hurt	ㅎㅓㅌㅡ
hilbert	ㅎㅣㄹㅂㅓㅌㅡ
akhmetov	ㅇㅏㅎㅡㅁㅔㅌㅗㅍㅡ
ogawa	ㅇㅗㄱㅏㅇㅘ
aceves	ㅇㅏㅅㅔㅂㅔㅅㅡ
odell	ㅇㅗㄷㅔㄹ
darby	ㄷㅏㅂㅣ
fiennes	ㅍㅏㅇㅣㄴㅅㅡ
romero	ㄹㅗㅁㅔㄹㅗ
arnulf	ㅇㅏㄹㅡㄴㅜㄹㅍㅡ
monaco	ㅁㅗㄴㅏㅋㅗ
thorpe	ㅅㅗㅍㅡ
boyd	ㅂㅗㅇㅣㄷㅡ
shakir	ㅅㅑㅋㅣㄹㅡ
greenberg	ㄱㅡㄹㅣㄴㅂㅓㄱㅡ
gilbert	ㄱㅣㄹㅂㅓㅌㅡ
alfred	ㅇㅏㄹㅍㅡㄹㅔㄷㅡ
mori	ㅁㅗㄹㅣ
mackay	ㅁㅐㅋㅔㅇㅣ
atticus	ㅇㅐㅌㅣㅋㅓㅅㅡ
vin	ㅂㅣㄴ
carmichael	ㅋㅏㅁㅏㅇㅣㅋㅡㄹ
klara	ㅋㅡㄹㄹㅏㄹㅏ
haase	ㅎㅏㅈㅔ
navarre	ㄴㅏㅂㅏㄹㅡ
sandler	ㅅㅐㄴㄷㅡㄹㄹㅓ
cleveland	ㅋㅡㄹㄹㅣㅂㅡㄹㄹㅐㄴㄷㅡ
onassis	ㅇㅗㄴㅏㅅㅣㅅㅡ
sander	ㅅㅐㄴㄷㅓ
rodolfo	ㄹㅗㄷㅗㄹㅍㅗ
dawn	ㄷㅗㄴ
curtin	ㅋㅓㅌㅣㄴ
rosemary	ㄹㅗㅈㅡㅁㅔㄹㅣ
cliff	ㅋㅡㄹㄹㅣㅍㅡ
dole	ㄷㅗㄹ
jin	ㅈㅣㄴ
ahn	ㅇㅏㄴ
lodovico	ㄹㅗㄷㅗㅂㅣㅋㅗ
portillo	ㅍㅗㄹㅡㅌㅣㅇㅛ
phelps	ㅍㅔㄹㅍㅡㅅㅡ
sardou	ㅅㅏㄹㅡㄷㅜ
nobuhiro	ㄴㅗㅂㅜㅎㅣㄹㅗ
steffen	ㅅㅠㅌㅔㅍㅔㄴ
sloane	ㅅㅡㄹㄹㅗㄴ
ksenia	ㅋㅡㅅㅔㄴㅣㅇㅑ
aston	ㅇㅐㅅㅡㅌㅓㄴ
ebert	ㅇㅔㅂㅔㄹㅡㅌㅡ
grahame	ㄱㅡㄹㅔㅇㅣㅇㅓㅁ
ivar	ㅇㅣㅂㅏㄹㅡ
scala	ㅅㅡㅋㅏㄹㄹㅏ
abe	ㅇㅏㅂㅔ
greco	ㄱㅡㄹㅔㅋㅗ
masaki	ㅅㅏㅇㅣㅌㅗ
reed	ㄹㅣㄷㅡ
dixon	ㄷㅣㄱㅅㅡㄴ
arabia	ㅇㅏㅈㅣㅈㅡ
bridget	ㅂㅡㄹㅣㅈㅣㅅ
danijel	ㄷㅏㄴㅣㅇㅖㄹ
nabeshima	ㄴㅏㅂㅔㅅㅣㅁㅏ
eusebio	ㅇㅔㅇㅜㅅㅔㅂㅣㅇㅗ
suppiluliuma	ㅅㅜㅍㅣㄹㄹㅠㄹㄹㅣㅇㅜㅁㅏ
beatty	ㅂㅣㅌㅣ
sanon	ㅅㅏㄴㅗㄴ
takahashi	ㄷㅏㅋㅏㅎㅏㅅㅣ
maciel	ㅁㅏㅅㅣㅇㅔㅇㅜ
hartley	ㅎㅏㅌㅡㄹㄹㅣ
melky	ㅁㅔㄹㅋㅣ
cem	ㅈㅔㅁ
dudu	ㄷㅜㄷㅜ
porter	ㅍㅗㅌㅓ
zima	ㅈㅣㅁㅏ
hurley	ㅎㅓㄹㄹㅣ
angelique	ㅇㅏㄴㅈㅔㄹㄹㅣㅋㅡ
valerius	ㅂㅏㄹㄹㅔㄹㅣㅇㅜㅅㅡ
cheney	ㅊㅔㄴㅣ
johnny	ㅈㅗㄴㅣ
newman	ㄴㅠㅁㅓㄴ
chick	ㅊㅣㄱ
abendroth	ㅇㅏㅂㅔㄴㅌㅡㄹㅗㅌㅡ
isaiah	ㅇㅏㅇㅣㅈㅔㅇㅣㅇㅏ
chase	ㅊㅔㅇㅣㅅㅡ
benz	ㅂㅔㄴㅈㅡ
sotiris	ㅅㅗㅌㅣㄹㅣㅅㅡ
yorn	ㅇㅛㄴ
hamm	ㅎㅐㅁ
carrasco	ㅋㅏㄹㅏㅅㅡㅋㅗ
houten	ㅎㅏㅇㅜㅌㅓㄴ
fang	ㅍㅏㅇ
romano	ㄹㅗㅁㅏㄴㅗ
rosales	ㄹㅗㅅㅏㄹㄹㅔㅅㅡ
dakota	ㄷㅏㅋㅗㅌㅏ
juan	ㅎㅜㅇㅏㄴ
grabowska	ㄱㅡㄹㅏㅂㅗㅍㅡㅅㅡㅋㅏ
elihu	ㅇㅔㄹㄹㅣㅎㅜ
mansart	ㅁㅏㅇㅅㅏㄹㅡ
bayram	ㅂㅏㅇㅣㄹㅏㅁ
jarrett	ㅈㅐㄹㅓㅅ
colonna	ㅋㅗㄹㄹㅗㄴㄴㅏ
albin	ㅇㅏㄹㅂㅣㄴ
veniamin	ㅂㅔㄴㅣㅇㅏㅁㅣㄴ
guidantonio	ㄱㅜㅇㅣㄷㅏㄴㅌㅗㄴㅣㅇㅗ
walton	ㅇㅝㄹㅌㅓㄴ
abubakar	ㅇㅏㅂㅜㅂㅏㅋㅏㄹㅡ
yasushige	ㅇㅑㅅㅡㅅㅣㄱㅔ
kirui	ㅋㅣㄹㅜㅇㅣ
casiraghi	ㅋㅏㅅㅣㄹㅏㄱㅣ
mckay	ㅁㅐㅋㅔㅇㅣ
huynh	ㅎㅜㅇㅣㄴ
viggo	ㅂㅣㄱㅗ
bauman	ㅂㅏㅇㅜㅁㅏㄴ
voronin	ㅂㅗㄹㅗㄴㅣㄴ
sayed	ㅅㅏㅇㅖㄷㅡ
infantino	ㅇㅣㄴㅍㅏㄴㅌㅣㄴㅗ
gianluigi	ㅈㅏㄴㄹㅜㅇㅣㅈㅣ
edgar	ㅇㅔㄷㅡㄱㅓ
shada	ㅅㅔㅇㅣㄷㅓ
miyamoto	ㅁㅣㅇㅑㅁㅗㅌㅗ
ferhat	ㅍㅔㄹㅡㅎㅏㅌㅡ
kamini	ㅋㅏㅁㅣㄴㅣ
pierre	ㅍㅣㅇㅔㄹㅡ
barr	ㅂㅏ
bakary	ㅂㅏㅋㅏㄹㅣ
sophie	ㅅㅗㅍㅣ
antonov	ㅇㅏㄴㅌㅗㄴㅗㅍㅡ
date	ㄷㅏㅌㅔ
sterling	ㅅㅡㅌㅓㄹㄹㅣㅇ
haney	ㅎㅔㅇㅣㄴㅣ
darrell	ㄷㅐㄹㅓㄹ
yoriyuki	ㅇㅛㄹㅣㅇㅠㅋㅣ
takahiro	ㄷㅏㅋㅏㅎㅣㄹㅗ
yarovenko	ㅇㅑㄹㅗㅂㅔㄴㅋㅗ
tarmo	ㅌㅏㄹㅡㅁㅗ
wain	ㅇㅞㅇㅣㄴ
nikolov	ㄴㅣㅋㅗㄹㄹㅗㅍㅡ
giray	ㄱㅣㄹㅏㅇㅣ
acosta	ㅇㅏㅋㅗㅅㅡㅌㅏ
chaves	ㅅㅑㅂㅔㅅㅡ
gilford	ㄱㅣㄹㅍㅓㄷㅡ
meri	ㅁㅔㄹㅣ
hutch	ㅎㅓㅊㅣ
vogt	ㅍㅗㅋㅡㅌㅡ
izabella	ㅇㅣㅈㅏㅂㅔㄹㄹㅏ
trucks	ㅌㅡㄹㅓㄱㅅㅡ
zee	ㅈㅣ
bernstein	ㅂㅓㄴㅅㅡㅌㅏㅇㅣㄴ
patton	ㅍㅐㅌㅡㄴ
zeman	ㅈㅔㅁㅏㄴ
tadatoshi	ㄷㅏㄷㅏㅌㅗㅅㅣ
lindroos	ㄹㅣㄴㄷㅡㄹㅗㅅㅡ
luchino	ㄹㅜㅋㅣㄴㅗ
flair	ㅍㅡㄹㄹㅔㅇㅓ
botto	ㅂㅗㅌㅗ
mill	ㅁㅣㄹ
neferkamin	ㄴㅔㅍㅔㄹㅡㅋㅏㅁㅣㄴ
lamy	ㄹㅏㅁㅣ
borg	ㅂㅗㄱㅡ
newell	ㄴㅠㅇㅞㄹ
stewart	ㅅㅡㅌㅠㅇㅓㅌㅡ
romer	ㄹㅗㅁㅓ
conor	ㅋㅗㄴㅓ
cusack	ㅋㅠㅈㅐㄱ
wegener	ㅂㅔㄱㅔㄴㅓ
press	ㅍㅡㄹㅔㅅㅡ
justice	ㅈㅓㅅㅡㅌㅣㅅㅡ
avi	ㅇㅏㅂㅣ
paisley	ㅍㅔㅇㅣㅈㅡㄹㄹㅣ
duarte	ㄷㅜㅇㅏㄹㅡㅌㅔ
albert	ㅇㅐㄹㅂㅓㅌㅡ
yevhen	ㅇㅖㅇㅜㅎㅔㄴ
dimaggio	ㄷㅣㅁㅏㅈㅣㅇㅗ
wilfried	ㅇㅟㄹㅍㅡㄹㅣㄷㅡ
sakai	ㅅㅏㅋㅏㅇㅣ
celeste	ㅅㅔㄹㄹㅔㅅㅡㅌㅔ
ivanovich	ㅇㅣㅂㅏㄴㅗㅂㅣㅊㅣ
rahmon	ㄹㅏㅎㅡㅁㅗㄴ
yoshimichi	ㅇㅛㅅㅣㅁㅣㅊㅣ
stamitz	ㅅㅠㅌㅏㅁㅣㅊㅡ
kogan	ㅋㅗㄱㅏㄴ
jones	ㅈㅗㄴㅅㅡ
sigrid	ㅅㅣㄱㅡㄹㅣㄷㅡ
metcalfe	ㅁㅔㅅㅋㅓㅍㅡ
slick	ㅅㅡㄹㄹㅣㄱ
maksim	ㅁㅏㄱㅅㅣㅁ
myrdal	ㅁㅟㄹㅡㄷㅏㄹ
amy	ㅇㅔㅇㅣㅁㅣ
angle	ㅇㅐㅇㄱㅡㄹ
daddy	ㄷㅐㄷㅣ
shanina	ㅅㅑㄴㅣㄴㅏ
nobuteru	ㄴㅗㅂㅜㅌㅔㄹㅜ
polyakov	ㅍㅗㄹㄹㅑㅋㅗㅍㅡ
silvio	ㅅㅣㄹㅂㅣㅇㅗ
ziad	ㅈㅣㅇㅏㄷㅡ
elvira	ㅇㅔㄹㅂㅣㄹㅏ
fatih	ㅍㅏㅌㅣㅎㅡ
sidkeong	ㅅㅣㄷㅡㅋㅔㅇㅗㅇ
witherspoon	ㅇㅟㄷㅓㅅㅡㅍㅜㄴ
cuomo	ㅋㅜㅇㅗㅁㅗ
hamdallah	ㅎㅏㅁㄷㅏㄹㄹㅏ
saba	ㅅㅏㅂㅏ
schacht	ㅅㅑㅎㅡㅌㅡ
bertrand	ㅂㅔㄹㅡㅌㅡㄹㅏㅇ
svetlana	ㅅㅡㅂㅔㅌㅡㄹㄹㅏㄴㅏ
gagnon	ㄱㅏㄴㅛㅇ
sand	ㅅㅏㄴ
hill	ㅎㅣㄹ
aron	ㅇㅏㄹㅗㄴ
luka	ㄹㅜㅋㅏ
yu	ㅇㅠ
pandolfo	ㅍㅏㄴㄷㅗㄹㅍㅗ
sylwia	ㅅㅣㄹㅂㅣㅇㅏ
ebeling	ㅇㅔㅂㅔㄹㄹㅣㅇ
jacobs	ㅈㅔㅇㅣㅋㅓㅂㅅㅡ
grammer	ㄱㅡㄹㅐㅁㅓ
senna	ㅅㅔㄴㅏ
dickens	ㄷㅣㅋㅣㄴㅅㅡ
chung	ㅊㅓㅇ
stubbs	ㅅㅡㅌㅓㅂㅅㅡ
marsh	ㅁㅏㅅㅣ
augusto	ㅇㅏㅇㅜㄱㅜㅅㅡㅌㅜ
mariano	ㅁㅏㄹㅣㅇㅏㄴㅗ
neruda	ㄴㅔㄹㅜㄷㅏ
liv	ㄹㅣㅂㅡ
roma	ㄹㅗㅁㅏ
ebanks	ㅇㅣㅂㅐㅇㅋㅡㅅㅡ
adel	ㅇㅏㄷㅔㄹ
mcdonnell	ㅁㅐㄱㄷㅗㄴㅔㄹ
toro	ㅌㅗㄹㅗ
sheldon	ㅅㅖㄹㄷㅓㄴ
matsudaira	ㅁㅏㅆㅡㄷㅏㅇㅣㄹㅏ
piero	ㅍㅣㅇㅔㄹㅗ
debby	ㄷㅔㅂㅣ
montoya	ㅁㅗㄴㅌㅗㅇㅑ
lehtonen	ㄹㅔㅌㅗㄴㅔㄴ
seydou	ㅅㅔㅇㅣㄷㅜ
olena	ㅇㅗㄹㄹㅔㄴㅏ
lavinia	ㄹㅏㅂㅣㄴㅣㅇㅏ
kogo	ㅋㅗㄱㅗ
shinji	ㅅㅏㅌㅗ
tamara	ㅌㅏㅁㅏㄹㅏ
montanari	ㅁㅗㄴㅌㅏㄴㅏㄹㅣ
djorkaeff	ㅈㅗㄹㅡㅋㅏㅇㅔㅍㅡ
texas	ㅌㅔㄱㅅㅏㅅㅡ
pico	ㅍㅣㅋㅗ
elvis	ㅇㅔㄹㅂㅣㅅㅡ
amanda	ㅇㅓㅁㅐㄴㄷㅏ
ayer	ㅇㅔㅇㅣㅇㅓ
noah	ㄴㅗㅇㅏ
arroyo	ㅇㅏㄹㅗㅇㅛ
pippa	ㅍㅣㅍㅏ
grenier	ㄱㅡㄹㅡㄴㅣㅇㅔ
gregory	ㄱㅡㄹㅔㄱㅗㄹㅣ
bean	ㅂㅣㄴ
tozzi	ㅌㅗㅈㅣ
topol	ㅌㅗㅍㅗㄹ
forsberg	ㅍㅗㄹㅡㅅㅡㅂㅔㄹㅣ
reagan	ㄹㅔㅇㅣㄱㅓㄴ
simonov	ㅅㅣㅁㅗㄴㅗㅍㅡ
jason	ㅈㅔㅇㅣㅅㅡㄴ
casas	ㅋㅏㅅㅏㅅㅡ
foxe	ㅍㅗㄱㅅㅡ
kitty	ㅋㅣㅌㅣ
scarlett	ㅅㅡㅋㅏㄹㄹㅔㅅ
marcos	ㅁㅏㄹㅡㅋㅗㅅㅡ
aaltonen	ㅇㅏㄹㅌㅗㄴㅔㄴ
isadora	ㅇㅣㅅㅏㄷㅗㄹㅏ
carradine	ㅋㅐㄹㅓㄷㅣㄴ
larissa	ㄹㅏㄹㅣㅅㅏ
zabaleta	ㅅㅏㅂㅏㄹㄹㅔㅌㅏ
demis	ㄷㅔㅁㅣㅅㅡ
kuosmanen	ㅋㅜㅇㅗㅅㅡㅁㅏㄴㅔㄴ
whelan	ㅇㅞㄹㄹㅓㄴ
sellers	ㅅㅔㄹㄹㅓㅅㅡ
sexton	ㅅㅔㄱㅅㅡㅌㅓㄴ
debi	ㄷㅔㅂㅣ
barrow	ㅂㅐㄹㅗ
lie	ㄹㅣ
bourne	ㅂㅗㄴ
iron	ㅇㅏㅇㅣㅇㅓㄴ
novikov	ㄴㅗㅂㅣㅋㅗㅍㅡ
torrence	ㅌㅗㄹㅓㄴㅅㅡ
condon	ㅋㅗㄴㄷㅓㄴ
busby	ㅂㅓㅅㅡㅂㅣ
stelios	ㅅㅡㅌㅔㄹㄹㅣㅇㅗㅅㅡ
kasey	ㅋㅔㅇㅣㅅㅣ
ellie	ㅇㅔㄹㄹㅣ
jemma	ㅈㅔㅁㅁㅏ
barrymore	ㅂㅐㄹㅣㅁㅗㅇㅓ
beasley	ㅂㅣㅈㅡㄹㄹㅣ
empress	ㅍㅖㅎㅜ
tesoro	ㅌㅔㅅㅗㄹㅗ
albayrak	ㅇㅏㄹㅂㅏㅇㅣㄹㅏㄱ
kasia	ㅋㅏㅅㅣㅇㅏ
ronaldo	ㅎㅗㄴㅏㅇㅜㄷㅜ
fernando	ㅍㅔㄹㅡㄴㅏㄴㄷㅗ
lenoir	ㄹㅡㄴㅜㅇㅏㄹㅡ
menander	ㅁㅔㄴㅏㄴㄷㅡㄹㅗㅅㅡ
bellows	ㅂㅔㄹㄹㅗㅅㅡ
gordy	ㄱㅗㄷㅣ
kitabatake	ㅋㅣㅌㅏㅂㅏㅌㅏㅋㅔ
tatiana	ㅌㅏㅌㅣㅇㅏㄴㅏ
juraj	ㅇㅠㄹㅏㅇㅣ
sanderson	ㅅㅐㄴㄷㅓㅅㅡㄴ
dominique	ㄷㅗㅁㅣㄴㅣㅋㅡ
sale	ㅅㅔㅇㅣㄹ
graves	ㄱㅡㄹㅔㅇㅣㅂㅡㅅㅡ
kirke	ㅋㅓㅋㅡ
lothar	ㄹㅗㅌㅏㅇㅓ
park	ㅂㅏㄱ
keita	ㅋㅔㅇㅣㅌㅏ
leah	ㄹㅣㅇㅏ
naoyuki	ㄴㅏㅇㅗㅇㅠㅋㅣ
takanobu	ㄷㅏㅋㅏㄴㅗㅂㅜ
saito	ㅇㅠㅋㅣ
vlasov	ㅂㅡㄹㄹㅏㅅㅗㅍㅡ
lerner	ㄹㅓㄴㅓ
bin	ㅂㅣㄴ
miou	ㅁㅣㅇㅜ
baylor	ㅂㅔㅇㅣㄹㄹㅓ
yasukatsu	ㅇㅑㅅㅡㅋㅏㅆㅡ
malatesta	ㅁㅏㄹㄹㅏㅌㅔㅅㅡㅌㅏ
mueller	ㅁㅠㄹㄹㅓ
adad	ㅇㅏㄷㅏㄷㅡ
adorno	ㅇㅏㄷㅗㄹㅡㄴㅗ
kieron	ㅋㅣㄹㅓㄴ
robin	ㄹㅗㅂㅣㄴ
ruslan	ㄹㅜㅅㅡㄹㄹㅏㄴ
hendry	ㅎㅔㄴㄷㅡㄹㅣ
eliza	ㅇㅔㄹㄹㅣㅈㅏ
flo	ㅍㅡㄹㄹㅗ
carioca	ㅋㅏㄹㅣㅇㅗㅋㅏ
stefania	ㅅㅡㅌㅔㅍㅏㄴㅣㅇㅏ
colvin	ㅋㅗㄹㅂㅣㄴ
olha	ㅇㅗㄹㄱㅏ
sayyid	ㅅㅏㅇㅣㄷㅡ
traci	ㅌㅡㄹㅔㅇㅣㅅㅣ
eriksen	ㅇㅔㄹㅣㄱㅅㅔㄴ
pentti	ㅍㅔㄴㅌㅣ
parsons	ㅍㅏㅅㅡㄴㅅㅡ
juliet	ㅈㅜㄹㄹㅣㅇㅔㅅ
marshall	ㅁㅏㅅㅕㄹ
dear	ㄷㅣㅇㅓ
randy	ㄹㅐㄴㄷㅣ
enrico	ㅇㅔㄴㄹㅣㅋㅗ
carides	ㅋㅏㄹㅣㄷㅔㅅㅡ
lenny	ㄹㅔㄴㅣ
oreilly	ㅇㅗㄹㅏㅇㅣㄹㄹㅣ
remy	ㄹㅔㅁㅣ
gretchen	ㄱㅡㄹㅔㅊㅓㄴ
maine	ㅁㅔㅇㅣㄴ
dietrich	ㄷㅣㅌㅡㄹㅣㅎㅣ
abbey	ㅇㅐㅂㅣ
oconnor	ㅇㅗㅋㅗㄴㅓ
tarantino	ㅌㅏㄹㅏㄴㅌㅣㄴㅗ
ari	ㅇㅏㄹㅣ
pieter	ㅍㅣㅌㅓㄹㅡ
yuki	ㅅㅏㅇㅣㅌㅗ
berkeley	ㅂㅓㅋㅡㄹㄹㅣ
schwartz	ㅅㅠㅂㅏㄹㅡㅊㅡ
oconnell	ㅇㅗㅋㅗㄴㅔㄹ
bey	ㅂㅔㅇㅣ
oswalt	ㅇㅗㅅㅡㅇㅘㄹㅌㅡ
fleetwood	ㅍㅡㄹㄹㅣㅌㅡㅇㅜㄷㅡ
mccormack	ㅁㅐㅋㅗㅁㅐㄱ
and	ㅇㅐㄴ
malina	ㅁㅏㄹㄹㅣㄴㅏ
spong	ㅅㅡㅍㅗㅇ
deeley	ㄷㅣㄹㄹㅣ
berri	ㅂㅔㄹㅣ
heiko	ㅎㅏㅇㅣㅋㅗ
pickford	ㅍㅣㄱㅍㅓㄷㅡ
keeley	ㅋㅣㄹㄹㅣ
yorke	ㅇㅛㅋㅡ
addison	ㅇㅐㄷㅣㅅㅡㄴ
wyatt	ㅇㅘㅇㅣㅇㅓㅌㅡ
cannon	ㅋㅐㄴㅓㄴ
oppenheimer	ㅇㅗㅍㅔㄴㅎㅏㅇㅣㅁㅓ
denise	ㄷㅔㄴㅣㅅㅡ
rik	ㄹㅣㄱ
birgit	ㅂㅣㄹㅡㄱㅣㅌㅡ
ferry	ㅍㅔㄹㅣ
gaddafi	ㅋㅏㄷㅏㅍㅣ
shaw	ㅅㅛ
chau	ㅊㅏㅇㅜ
hickman	ㅎㅣㄱㅁㅐㄴ
cosmin	ㅋㅗㅅㅡㅁㅣㄴ
thaler	ㅌㅏㄹㄹㅓ
semih	ㅅㅔㅁㅣㅎㅡ
gordon	ㄱㅗㄷㅡㄴ
lehmann	ㄹㅔㅁㅏㄴ
saori	ㅅㅏㅇㅗㄹㅣ
nobunaga	ㄴㅗㅂㅜㄴㅏㄱㅏ
cid	ㅅㅣㄷㅡ
narimasa	ㄴㅏㄹㅣㅁㅏㅅㅏ
joachim	ㅇㅛㅇㅏㅎㅣㅁ
rabbani	ㄹㅏㅂㅏㄴㅣ
michalka	ㅁㅣㅅㅑㅋㅏ
bravo	ㅂㅡㄹㅏㅂㅗ
tadasuke	ㄷㅏㄷㅏㅅㅡㅋㅔ
masanori	ㅁㅏㅅㅏㄴㅗㄹㅣ
hagen	ㅎㅏㄱㅔㄴ
wieland	ㅂㅣㄹㄹㅏㄴㅌㅡ
petro	ㅍㅔㅌㅡㄹㅗ
agesilaus	ㅇㅏㄱㅔㅅㅣㄹㄹㅏㅇㅗㅅㅡ
jermain	ㅈㅓㅁㅔㅇㅣㄴ
pamela	ㅍㅐㅁㅓㄹㄹㅏ
harman	ㅎㅏㅁㅓㄴ
itamar	ㅇㅣㅌㅏㅁㅏㄹㅡ
leif	ㄹㅔㅇㅣㅍㅡ
hosokawa	ㅎㅗㅅㅗㅋㅏㅇㅘ
makino	ㅁㅏㅋㅣㄴㅗ
aaron	ㅇㅔㄹㅓㄴ
limardo	ㄹㅣㅁㅏㄹㅡㄷㅗ
blobel	ㅂㅡㄹㄹㅗㅂㅔㄹ
hertz	ㅎㅔㄹㅡㅊㅡ
bona	ㅂㅗㄴㅏ
faye	ㅍㅔㅇㅣ
rima	ㄹㅣㅁㅏ
despina	ㄷㅔㅅㅡㅍㅣㄴㅏ
de	ㄷㅡ
schultz	ㅅㅠㄹㅊㅡ
lindemann	ㄹㅣㄴㄷㅔㅁㅏㄴ
mireille	ㅁㅣㄹㅔㅇㅠ
osment	ㅇㅗㅅㅡㅁㅓㄴㅌㅡ
chan	ㅊㅐㄴ
olof	ㅇㅗㄹㄹㅗㅍㅡ
kikkawa	ㄱㅣㅅㅋㅏㅇㅘ
myron	ㅁㅏㅇㅣㄹㅓㄴ
law	ㄹㅗ
young	ㅇㅕㅇ
nagai	ㄴㅏㄱㅏㅇㅣ
fiedler	ㅍㅣㄷㅡㄹㄹㅓ
marit	ㅁㅏㄹㅣㅌㅡ
keating	ㅋㅣㅌㅣㅇ
naonori	ㄴㅏㅇㅗㄴㅗㄹㅣ
fanning	ㅍㅐㄴㅣㅇ
foner	ㅍㅗㄴㅓ
malene	ㅁㅏㄹㄹㅔㄴㅔ
chantal	ㅅㅑㅇㅌㅏㄹ
stanley	ㅅㅡㅌㅐㄴㄹㅣ
louise	ㄹㅜㅇㅣㅈㅡ
brochu	ㅂㅡㄹㅗㅅㅠ
durham	ㄷㅓㄹㅓㅁ
nicolaas	ㄴㅣㅋㅗㄹㄹㅏㅅㅡ
konstantin	ㅋㅗㄴㅅㅡㅌㅏㄴㅌㅣㄴ
phaneuf	ㅍㅏㄴㅚㅍㅡ
kidder	ㅋㅣㄷㅓ
gilmore	ㄱㅣㄹㅁㅗㅇㅓ
baggio	ㅂㅏㅈㅗ
eagle	ㅇㅣㄱㅡㄹ
appleby	ㅇㅐㅍㅡㄹㅂㅣ
yigal	ㅇㅣㄱㅏㄹ
mateos	ㅁㅏㅌㅔㅇㅗㅅㅡ
naomasa	ㄴㅏㅇㅗㅁㅏㅅㅏ
randolph	ㄹㅐㄴㄷㅗㄹㅍㅡ
haven	ㅎㅔㅇㅣㅂㅡㄴ
vito	ㅂㅣㅌㅗ
mcmahon	ㅁㅐㄱㅁㅏㅎㅡㄴ
bhargava	ㅂㅏㄹㅡㄱㅏㅂㅏ
biddle	ㅂㅣㄷㅡㄹ
karel	ㅋㅏㄹㅔㄹ
diaz	ㄷㅣㅇㅏㅈㅡ
bernardino	ㅂㅔㄹㅡㄴㅏㄹㅡㄷㅣㄴㅗ
janez	ㅇㅑㄴㅔㅈㅡ
rothman	ㄹㅗㅅㅡㅁㅓㄴ
kaitlyn	ㅋㅔㅇㅣㅌㅡㄹㄹㅣㄴ
kaspar	ㅋㅏㅅㅡㅍㅏㄹㅡ
ludovico	ㄹㅜㄷㅗㅂㅣㅋㅗ
grillo	ㄱㅡㄹㅣㄹㄹㅗ
stevenson	ㅅㅡㅌㅣㅂㅡㄴㅅㅡㄴ
omalley	ㅇㅗㅁㅏㄹㄹㅣ
torrado	ㅌㅗㄹㅏㄷㅗ
felipe	ㅍㅔㄹㄹㅣㅍㅔ
marcia	ㅁㅏㅅㅑ
alfredson	ㅇㅏㄹㅍㅡㄹㅔㄷㅡㅅㅗㄴ
beatriz	ㅂㅔㅇㅏㅌㅡㄹㅣㅅㅡ
nagy	ㄴㅏㅈㅣ
har	ㅎㅏㄹㅡ
mcgovern	ㅁㅐㄱㄱㅓㅂㅓㄴ
colt	ㅋㅗㄹㅌㅡ
sutton	ㅅㅓㅌㅓㄴ
elise	ㅇㅔㄹㄹㅣㅅㅡ
lars	ㄹㅏㄹㅡㅅㅡ
jordi	ㅎㅗㄹㅡㄷㅣ
hartwig	ㅎㅏㄹㅡㅌㅡㅂㅣㅎㅣ
ephraim	ㅇㅔㅍㅡㄹㅏㅇㅣㅁ
mathieu	ㅁㅏㅌㅣㅇㅚ
karen	ㅋㅐㄹㅓㄴ
christophe	ㅋㅡㄹㅣㅅㅡㅌㅗㅍㅡ
dooley	ㄷㅜㄹㄹㅣ
cummings	ㅋㅓㅁㅣㅇㅅㅡ
hiroshi	ㅎㅣㄹㅗㅅㅣ
thierry	ㅌㅣㅇㅔㄹㅣ
angelica	ㅇㅏㄴㅈㅔㄹㄹㅣㅋㅏ
joyner	ㅈㅗㅇㅣㄴㅓ
tobin	ㅌㅗㅂㅣㄴ
anita	ㅇㅏㄴㅣㅌㅏ
lin	ㄹㅣㄴ
cleomenes	ㅋㅡㄹㄹㅔㅇㅗㅁㅔㄴㅔㅅㅡ
garfield	ㄱㅏㅍㅣㄹㄷㅡ
irena	ㅇㅣㄹㅔㄴㅏ
merton	ㅁㅓㅌㅡㄴ
currie	ㅋㅓㄹㅣ
brun	ㅂㅡㄹㅜㄴ
hotta	ㅎㅗㅅㅌㅏ
capaldi	ㅋㅏㅍㅏㄹㄷㅣ
harley	ㅎㅏㄹㄹㅣ
sadiq	ㅅㅏㄷㅣㅋㅡ
pardo	ㅍㅏㄹㅡㄷㅗ
tate	ㅌㅔㅇㅣㅌㅡ
jaap	ㅇㅑㅍㅡ
lacy	ㄹㅔㅇㅣㅅㅣ
hickey	ㅎㅣㅋㅣ
singer	ㅅㅣㅇㅇㅓ
ripley	ㄹㅣㅍㅡㄹㄹㅣ
luca	ㄹㅜㅋㅏ
sampson	ㅅㅐㅁㅍㅡㅅㅡㄴ
collison	ㅋㅗㄹㄹㅣㅅㅡㄴ
donaldson	ㄷㅗㄴㅓㄹㄷㅡㅅㅡㄴ
hidemasa	ㅎㅣㄷㅔㅁㅏㅅㅏ
enver	ㅇㅔㄴㅂㅔㄹㅡ
jace	ㅈㅔㅇㅣㅅㅡ
astorre	ㅇㅏㅅㅡㅌㅗㄹㅔ
genevieve	ㅈㅔㄴㅔㅂㅣㅂㅡ
rockwell	ㄹㅗㄱㅇㅞㄹ
urban	ㅇㅓㅂㅓㄴ
dini	ㄷㅣㄴㅣ
walter	ㅇㅝㄹㅌㅓ
culp	ㅋㅓㄹㅍㅡ
kristoffer	ㅋㅡㄹㅣㅅㅡㅌㅗㅍㅔㄹㅡ
gethin	ㄱㅔㄷㅣㄴ
wolfram	ㅂㅗㄹㅍㅡㄹㅏㅁ
britta	ㅂㅡㄹㅣㅌㅏ
karembeu	ㅋㅏㄹㅏㅇㅂㅚ
kress	ㅋㅡㄹㅔㅅㅡ
keane	ㅋㅣㄴ
allman	ㅇㅗㄹㅁㅓㄴ
centa	ㅊㅔㄴㅌㅏ
mol	ㅁㅗㄹ
aliyev	ㅇㅏㄹㄹㅣㅇㅖㅍㅡ
comeau	ㅋㅗㅁㅗ
blunt	ㅂㅡㄹㄹㅓㄴㅌㅡ
lively	ㄹㅏㅇㅣㅂㅡㄹㄹㅣ
azai	ㅇㅏㅈㅏㅇㅣ
cristina	ㅋㅡㄹㅣㅅㅡㅌㅣㄴㅏ
clinton	ㅋㅡㄹㄹㅣㄴㅌㅓㄴ
paulus	ㅍㅏㅇㅜㄹㄹㅜㅅㅡ
neve	ㄴㅣㅂㅡ
rebecca	ㄹㅣㅂㅔㅋㅏ
jess	ㅈㅔㅅㅡ
mamie	ㅁㅔㅇㅣㅁㅣ
rodney	ㄹㅗㄷㅡㄴㅣ
rolfe	ㄹㅗㄹㅍㅡ
maass	ㅁㅏㅅㅡ
powell	ㅍㅏㅇㅝㄹ
meagan	ㅁㅣㄱㅓㄴ
ivanov	ㅇㅣㅂㅏㄴㅗㅍㅡ
arnaud	ㅇㅏㄹㅡㄴㅗ
boni	ㅂㅗㄴㅣ
pernilla	ㅍㅔㄹㅡㄴㅣㄹㄹㅏ
bock	ㅂㅗㅋㅡ
benteke	ㅂㅔㄴㅌㅔㅋㅔ
sosa	ㅅㅗㅅㅏ
hood	ㅎㅜㄷㅡ
imagawa	ㅇㅣㅁㅏㄱㅏㅇㅘ
justine	ㅈㅓㅅㅡㅌㅣㄴ
feliciano	ㅍㅔㄹㄹㅣㅅㅣㅇㅏㄴㅗ
reeve	ㄹㅣㅂㅡ
ethan	ㅇㅣㅅㅓㄴ
wulff	ㅂㅜㄹㅍㅡ
ravi	ㄹㅏㅂㅣ
stephens	ㅅㅡㅌㅣㅂㅡㄴㅅㅡ
rocky	ㄹㅗㅋㅣ
ologun	ㅇㅗㄹㄹㅗㄱㅓㄴ
leonid	ㄹㅔㅇㅗㄴㅣㅌㅡ
drayton	ㄷㅡㄹㅔㅇㅣㅌㅓㄴ
monteiro	ㅁㅗㄴㅌㅔㅇㅣㄹㅜ
vera	ㅂㅔㄹㅏ
waller	ㅇㅝㄹㄹㅓ
santa	ㅅㅏㄴㅌㅏ
vladislav	ㅂㅡㄹㄹㅏㄷㅣㅅㅡㄹㄹㅏㅍㅡ
terry	ㅌㅔㄹㅣ
branch	ㅂㅡㄹㅐㄴㅊㅣ
wilfred	ㅇㅟㄹㅍㅡㄹㅔㄷㅡ
saionji	ㅅㅏㅇㅣㅇㅗㄴㅈㅣ
katharine	ㅋㅐㅅㅓㄹㅣㄴ
davidson	ㄷㅔㅇㅣㅂㅣㄷㅡㅅㅡㄴ
spall	ㅅㅡㅍㅗㄹ
ace	ㅇㅔㅇㅣㅅㅡ
agis	ㅇㅏㄱㅣㅅㅡ
hamada	ㅁㅏㄹㅣ
menger	ㅁㅔㅇㄱㅓ
erkan	ㅇㅔㄹㅡㅋㅏㄴ
jan	ㅇㅑㄴ
biel	ㅂㅣㅇㅔㄹ
fallon	ㅍㅐㄹㄹㅓㄴ
riemann	ㄹㅣㅁㅏㄴ
aguinaldo	ㅇㅏㄱㅣㄴㅏㄹㄷㅗ
engel	ㅇㅔㅇㄱㅔㄹ
parysatis	ㅍㅏㄹㅣㅅㅏㅌㅣㅅㅡ
cook	ㅋㅜㄱ
berezovsky	ㅂㅔㄹㅔㅈㅗㅂㅅㅡㅋㅣ
eldridge	ㅇㅔㄹㄷㅡㄹㅣㅈㅣ
wakisaka	ㅇㅘㅋㅣㅅㅏㅋㅏ
castelo	ㅋㅏㅅㅡㅌㅔㄹㄹㅜ
lund	ㄹㅜㄴ
wheeler	ㅎㅟㄹㄹㅓ
filipe	ㅍㅣㄹㄹㅣㅍㅡ
brown	ㅂㅡㄹㅏㅇㅜㄴ
wunderlich	ㅂㅜㄴㄷㅔㄹㅡㄹㄹㅣㅎㅣ
kimberly	ㅋㅣㅁㅂㅓㄹㄹㅣ
rosario	ㄹㅗㅅㅏㄹㅣㅇㅗ
freund	ㅍㅡㄹㅗㅇㅣㄴㅌㅡ
chancellor	ㅊㅐㄴㅅㅡㄹㄹㅓ
reem	ㄹㅣㅁ
winters	ㅇㅟㄴㅌㅓㅅㅡ
hildegard	ㅎㅣㄹㄷㅔㄱㅏㄹㅡㅌㅡ
demirel	ㄷㅔㅁㅣㄹㅔㄹ
ximena	ㅎㅣㅁㅔㄴㅏ
brice	ㅂㅡㄹㅏㅇㅣㅅㅡ
frode	ㅍㅡㄹㅗㄷㅔ
hennig	ㅎㅔㄴㅣㄱㅡ
leopoldo	ㄹㅔㅇㅗㅍㅗㄹㄷㅗ
kaitlin	ㅋㅔㅇㅣㅌㅡㄹㄹㅣㄴ
ayaka	ㅇㅏㅇㅑㅋㅏ
robespierre	ㄹㅗㅂㅔㅅㅡㅍㅣㅇㅔㄹㅡ
francis	ㅍㅡㄹㅐㄴㅅㅣㅅㅡ
digby	ㄷㅣㄱㅂㅣ
jacques	ㅈㅏㅋㅡ
gradenigo	ㄱㅡㄹㅏㄷㅔㄴㅣㄱㅗ
reid	ㄹㅣㄷㅡ
manners	ㅁㅐㄴㅓㅅㅡ
saarinen	ㅅㅏㄹㅣㄴㅔㄴ
list	ㄹㅣㅅㅡㅌㅡ
schram	ㅅㅠㄹㅏㅁ
hawke	ㅎㅗㅋㅡ
mourad	ㅁㅜㄹㅏㄷㅡ
ramon	ㄹㅏㅁㅗㄴ
devlin	ㄷㅔㅂㅡㄹㄹㅣㄴ
rasmussen	ㄹㅏㅅㅡㅁㅜㅅㅔㄴ
johnnie	ㅈㅗㄴㅣ
temple	ㅌㅔㅁㅍㅡㄹ
sio	ㅅㅣㅇㅗ
fukushima	ㅎㅜㅋㅜㅅㅣㅁㅏ
salviati	ㅅㅏㄹㅂㅣㅇㅏㅌㅣ
hannigan	ㅎㅐㄴㅣㄱㅓㄴ
hudson	ㅎㅓㄷㅡㅅㅡㄴ
jelena	ㅇㅖㄹㄹㅔㄴㅏ
theodoros	ㅌㅔㅇㅗㄷㅗㄹㅗㅅㅡ
bucky	ㅂㅓㅋㅣ
callie	ㅋㅐㄹㄹㅣ
eggestein	ㅇㅔㄱㅔㅅㅠㅌㅏㅇㅣㄴ
mac	ㅁㅏㄱ
price	ㅍㅡㄹㅏㅇㅣㅅㅡ
santiago	ㅅㅏㄴㅌㅣㅇㅏㄱㅗ
trini	ㅌㅡㄹㅣㄴㅣ
pancho	ㅍㅏㄴㅊㅗ
araki	ㅇㅏㄹㅏㅋㅣ
choi	ㅊㅚ
gregg	ㄱㅡㄹㅔㄱㅡ
nicki	ㄴㅣㅋㅣ
campanella	ㅋㅏㅁㅍㅏㄴㅔㄹㄹㅏ
carell	ㅋㅓㄹㅔㄹ
deane	ㄷㅣㄴ
shelley	ㅅㅖㄹㄹㅣ
hewitt	ㅎㅠㅇㅣㅌㅡ
wade	ㅇㅞㅇㅣㄷㅡ
larkin	ㄹㅏㅋㅣㄴ
bosworth	ㅂㅗㅈㅡㅇㅝㅅㅡ
witte	ㅂㅣㅌㅔ
mahoney	ㅁㅓㅎㅗㄴㅣ
hendrix	ㅎㅔㄴㄷㅡㄹㅣㄱㅅㅡ
abdoul	ㅇㅏㅂㄷㅜㄹ
braun	ㅂㅡㄹㅏㅇㅜㄴ
ayres	ㅇㅔㅇㅓㅅㅡ
basso	ㅂㅏㅅㅗ
alena	ㅇㅏㄹㄹㅔㄴㅏ
noether	ㄴㅚㅌㅓ
bronson	ㅂㅡㄹㅗㄴㅅㅡㄴ
august	ㅇㅏㅇㅜㄱㅜㅅㅡㅌㅡ
arthaud	ㅇㅏㄹㅡㅌㅗ
koenig	ㅋㅔㅇㅣㄴㅣㄱㅡ
brenda	ㅂㅡㄹㅔㄴㄷㅏ
jaroslav	ㅇㅑㄹㅗㅅㅡㄹㄹㅏㅍㅡ
jacobsen	ㅇㅑㅋㅗㅂㅅㅔㄴ
rivas	ㄹㅣㅂㅏㅅㅡ
stefanos	ㅅㅡㅌㅔㅍㅏㄴㅗㅅㅡ
cowboy	ㅋㅏㅇㅜㅂㅗㅇㅣ
revere	ㄹㅣㅂㅣㅇㅓ
keisuke	ㅇㅗㅌㅏ
bamford	ㅂㅐㅁㅍㅗㄷㅡ
saad	ㅅㅏㄷㅡ
duchess	ㄷㅔㅂㅗㄴㅅㅑㅇㅣㅇㅓ
trina	ㅌㅡㄹㅣㄴㅏ
sylvester	ㅅㅣㄹㅂㅔㅅㅡㅌㅓ
york	ㅇㅛㅋㅡ
tia	ㅌㅣㅇㅏ
indiana	ㅇㅣㄴㄷㅣㅇㅐㄴㅏ
nobuyoshi	ㄴㅗㅂㅜㅇㅛㅅㅣ
hahn	ㅎㅏㄴ
yussuf	ㅇㅠㅅㅜㅍㅡ
shannon	ㅅㅒㄴㅓㄴ
rogelio	ㄹㅗㅎㅔㄹㄹㅣㅇㅗ
lucrezia	ㄹㅜㅋㅡㄹㅔㅊㅣㅇㅏ
brant	ㅂㅡㄹㅐㄴㅌㅡ
ozzie	ㅇㅏㅈㅣ
boateng	ㅂㅗㅇㅏㅌㅔㅇ
akratopoulos	ㅇㅏㅋㅡㄹㅏㅌㅗㅍㅜㄹㄹㅗㅅㅡ
kenji	ㄷㅏㅋㅏㅎㅏㅅㅣ
cresswell	ㅋㅡㄹㅔㅅㅡㅇㅞㄹ
trevor	ㅌㅡㄹㅔㅂㅓ
bayer	ㅂㅏㅇㅣㅇㅓ
dreyer	ㄷㅡㄹㅏㅇㅣㅇㅓ
lilian	ㄹㅣㄹㄹㅣㅇㅏㄴ
wolfgang	ㅂㅗㄹㅍㅡㄱㅏㅇ
duke	ㄷㅠㅋㅡ
aurore	ㅇㅗㄹㅗㄹㅡ
astrid	ㅇㅏㅅㅡㅌㅡㄹㅣㄷㅡ
memphis	ㅁㅔㅁㅍㅣㅅㅡ
shane	ㅅㅖㅇㅣㄴ
mitch	ㅁㅣㅊㅣ
gram	ㄱㅡㄹㅏㅁ
minsky	ㅁㅣㄴㅅㅡㅋㅣ
youssef	ㅇㅠㅅㅔㅍㅡ
giulio	ㅈㅜㄹㄹㅣㅇㅗ
wakefield	ㅇㅞㅇㅣㅋㅡㅍㅣㄹㄷㅡ
bojan	ㅂㅗㅇㅑㄴ
eman	ㅇㅔㅁㅏㄴ
guarini	ㄱㅘㄹㅣㄴㅣ
edna	ㅇㅔㄷㅡㄴㅏ
mr	ㅁㅣㅅㅡㅌㅓ
angelina	ㅇㅏㄴㅈㅔㄹㄹㅣㄴㅏ
vasily	ㅂㅏㅅㅣㄹㄹㅣ
syd	ㅅㅣㄷㅡ
jozef	ㅇㅛㅈㅔㅍㅡ
nobutoki	ㄴㅗㅂㅜㅌㅗㅋㅣ
diarra	ㄷㅣㅇㅏㄹㅏ
holt	ㅎㅗㄹㅌㅡ
bethany	ㅂㅔㅅㅓㄴㅣ
silver	ㅅㅣㄹㅂㅓ
mischa	ㅁㅣㅅㅑ
niall	ㄴㅏㅇㅣㅇㅓㄹ
ohare	ㅇㅗㅎㅔㅇㅓ
benediktsson	ㅂㅔㄴㅔㄷㅣㄱㅊㅡㅅㅗㄴ
serhiy	ㅅㅔㄹㅡㅎㅣ
abdoulaye	ㅇㅏㅂㄷㅜㄹㄹㅏㅇㅖ
takenaka	ㄷㅏㅋㅔㄴㅏㅋㅏ
diamond	ㄷㅏㅇㅣㅇㅏㅁㅗㄴㄷㅡ
scola	ㅅㅡㅋㅗㄹㄹㅏ
savant	ㅅㅏㅂㅏㄴㅌㅡ
cory	ㅋㅗㄹㅣ
pekka	ㅍㅔㅋㅏ
walt	ㅇㅝㄹㅌㅡ
harald	ㅎㅏㄹㅏㄹㅌㅡ
violeta	ㅂㅣㅇㅗㄹㄹㅔㅌㅏ
shota	ㅅㅛㅌㅏ
brandi	ㅂㅡㄹㅐㄴㄷㅣ
wu	ㅇㅜ
sassoon	ㅅㅏㅅㅜㄴ
steele	ㅅㅡㅌㅣㄹ
irvin	ㅇㅓㅂㅣㄴ
yoshinobu	ㅇㅛㅅㅣㄴㅗㅂㅜ
crystal	ㅋㅡㄹㅣㅅㅡㅌㅓㄹ
coolbaugh	ㅋㅜㄹㅂㅗ
semyon	ㅅㅔㅁㅛㄴ
underwood	ㅇㅓㄴㄷㅓㅇㅜㄷㅡ
lindvall	ㄹㅣㄴㄷㅡㅂㅏㄹ
amal	ㅇㅏㅁㅏㄹ
buchanan	ㅂㅠㅋㅐㄴㅓㄴ
sirhan	ㅅㅣㄹㅡㅎㅏㄴ
helman	ㅎㅔㄹㅁㅓㄴ
asap	ㅇㅔㅇㅣㅅㅔㅂ
eisner	ㅇㅏㅇㅣㅅㅡㄴㅓ
munari	ㅁㅜㄴㅏㄹㅣ
valencia	ㅂㅏㄹㄹㅔㄴㅅㅣㅇㅏ
lennon	ㄹㅔㄴㅓㄴ
alec	ㅇㅏㄹㄹㅔㄱ
nikolaj	ㄴㅣㅋㅗㄹㄹㅏㅇㅣ
jakob	ㅇㅑㅋㅗㅍㅡ
jamey	ㅈㅔㅇㅣㅁㅣ
cromwell	ㅋㅡㄹㅗㅁㅇㅞㄹ
schneider	ㅅㅠㄴㅏㅇㅣㄷㅓ
sotomayor	ㅅㅗㅌㅗㅁㅏㅇㅛㄹㅡ
anand	ㅇㅏㄴㅏㄴㄷㅡ
manfred	ㅁㅏㄴㅍㅡㄹㅔㅌㅡ
mikey	ㅁㅏㅇㅣㅋㅣ
thorne	ㅅㅗㄴ
keiko	ㅇㅏㅇㅣㅈㅏㅇㅘ
ellingson	ㅇㅔㄹㄹㅣㅇㅅㅡㄴ
rasputin	ㄹㅏㅅㅡㅍㅜㅌㅣㄴ
harlow	ㅎㅏㄹㄹㅗ
clayton	ㅋㅡㄹㄹㅔㅇㅣㅌㅓㄴ
rivero	ㄹㅣㅂㅔㄹㅗ
florence	ㅍㅡㄹㄹㅗㄹㅔㄴㅅㅡ
savage	ㅅㅐㅂㅣㅈㅣ
williamson	ㅇㅟㄹㄹㅣㅇㅓㅁㅅㅡㄴ
sienna	ㅅㅣㅇㅔㄴㅏ
groff	ㄱㅡㄹㅗㅍㅡ
dekker	ㄷㅔㅋㅓ
cecilia	ㅅㅔㅅㅣㄹㄹㅣㅇㅏ
katarina	ㅋㅏㅌㅏㄹㅣㄴㅏ
tori	ㅌㅗㄹㅣ
yvan	ㅇㅣㅂㅏㄴ
katy	ㅋㅔㅇㅣㅌㅣ
joey	ㅈㅗㅇㅣ
petty	ㅍㅔㅌㅣ
emmanuelle	ㅇㅔㅁㅏㄴㅟㅇㅔㄹ
schnabel	ㅅㅠㄴㅏㅂㅔㄹ
katsushige	ㄱㅏㅆㅡㅅㅣㄱㅔ
darlene	ㄷㅏㄹㄹㅣㄴ
bhutto	ㅂㅜㅌㅗ
panagiotis	ㅍㅏㄴㅏㅇㅛㅌㅣㅅㅡ
melinda	ㅁㅓㄹㄹㅣㄴㄷㅏ
karan	ㅋㅏㄹㅏㄴ
reggie	ㄹㅔㅈㅣ
stallone	ㅅㅡㅌㅐㄹㄹㅗㄴ
lagercrantz	ㄹㅏㄱㅔㄹㅡㅋㅡㄹㅏㄴㅊㅡ
funes	ㅍㅜㄴㅔㅅㅡ
bo	ㅂㅗ
israel	ㅇㅣㅈㅡㄹㅣㅇㅓㄹ
michelsen	ㅁㅣㅋㅔㄹㅅㅔㄴ
henrik	ㅎㅔㄴㄹㅣㅋㅡ
semyonov	ㅅㅔㅁㅛㄴㅗㅍㅡ
socha	ㅅㅗㅅㅑ
pasteur	ㅍㅏㅅㅡㅌㅚㄹㅡ
melissa	ㅁㅓㄹㄹㅣㅅㅏ
bloch	ㅂㅡㄹㄹㅗㅎㅡ
maarten	ㅁㅏㄹㅡㅌㅓㄴ
bartley	ㅂㅏㅌㅡㄹㄹㅣ
parnell	ㅍㅏㄴㅔㄹ
moussa	ㅁㅜㅅㅏ
herrmann	ㅎㅓㅁㅓㄴ
dano	ㄷㅏㄴㅗ
lia	ㄹㅣㅇㅏ
marla	ㅁㅏㄹㄹㅏ
urie	ㅇㅠㄹㅣ
fitch	ㅍㅣㅊㅣ
eochaid	ㅇㅗㅎㅏㄷㅡ
rubinstein	ㄹㅜㅂㅣㄴㅅㅡㅌㅏㅇㅣㄴ
taryn	ㅌㅏㄹㅣㄴ
mcshane	ㅁㅐㄱㅅㅖㅇㅣㄴ
frisch	ㅍㅡㄹㅣㅅㅠ
asier	ㅇㅏㅅㅣㅇㅔㄹㅡ
yoshihide	ㅇㅛㅅㅣㅎㅣㄷㅔ
lima	ㄹㅣㅁㅏ
tad	ㅌㅐㄷㅡ
josh	ㅈㅗㅅㅣ
ioannis	ㅇㅛㅇㅏㄴㄴㅣㅅㅡ
bruce	ㅂㅡㄹㅜㅅㅡ
cash	ㅋㅐㅅㅣ
theofilakis	ㅌㅔㅇㅗㅍㅣㄹㄹㅏㅋㅣㅅㅡ
yago	ㅇㅑㄱㅜ
robertson	ㄹㅗㅂㅓㅌㅡㅅㅡㄴ
ekman	ㅇㅔㅋㅡㅁㅏㄴ
eleftherios	ㅇㅔㄹㄹㅔㅍㅡㅌㅔㄹㅣㅇㅗㅅㅡ
leckie	ㄹㅔㅋㅣ
tiglath	ㅌㅣㄱㅡㄹㅏㅌㅡ
melinte	ㅁㅔㄹㄹㅣㄴㅌㅔ
hanson	ㅎㅐㄴㅅㅡㄴ
root	ㄹㅜㅌㅡ
francisca	ㅍㅡㄹㅏㄴㅅㅣㅅㅡㅋㅏ
mozart	ㅁㅗㅊㅏㄹㅡㅌㅡ
herzog	ㅎㅔㅇㅓㅊㅗㅋㅡ
penelope	ㅍㅓㄴㅔㄹㄹㅓㅍㅣ
mcnair	ㅁㅐㄱㄴㅔㅇㅓ
yoshimasa	ㅇㅛㅅㅣㅁㅏㅅㅏ
leon	ㄹㅣㅇㅓㄴ
samuel	ㅅㅐㅁㅠㅇㅓㄹ
hernando	ㅇㅔㄹㅡㄴㅏㄴㄷㅗ
papadopoulos	ㅍㅏㅍㅏㄷㅗㅍㅜㄹㄹㅗㅅㅡ
olga	ㅇㅗㄹㄱㅏ
herold	ㅎㅔㄹㅓㄹㄷㅡ
blom	ㅂㅡㄹㄹㅗㅁ
hannibal	ㅎㅐㄴㅣㅂㅓㄹ
jen	ㅈㅔㄴ
bart	ㅂㅏㅌㅡ
woodruff	ㅇㅜㄷㅡㄹㅓㅍㅡ
moss	ㅁㅗㅅㅡ
nazarova	ㄴㅏㅈㅏㄹㅗㅂㅏ
eastwood	ㅇㅣㅅㅡㅌㅡㅇㅜㄷㅡ
owens	ㅇㅗㅇㅓㄴㅅㅡ
gillan	ㄱㅣㄹㄹㅓㄴ
keyes	ㅋㅣㅅㅡ
sharman	ㅅㅑㅁㅓㄴ
imelda	ㅇㅣㅁㅔㄹㄷㅏ
mcqueen	ㅁㅐㅋㅟㄴ
rudin	ㄹㅜㄷㅣㄴ
hildebrand	ㅎㅣㄹㄷㅔㅂㅡㄹㅏㄴㅌㅡ
warner	ㅇㅝㄴㅓ
grigori	ㄱㅡㄹㅣㄱㅗㄹㅣ
ireland	ㅇㅏㅇㅣㄹㄹㅐㄴㄷㅡ
marte	ㅁㅏㄹㅡㅌㅔ
christiaan	ㅋㅡㄹㅣㅅㅡㅌㅣㅇㅏㄴ
jude	ㅈㅜㄷㅡ
von	ㅍㅗㄴ
hitler	ㅎㅣㅌㅡㄹㄹㅓ
terrence	ㅌㅔㄹㅓㄴㅅㅡ
atkins	ㅇㅐㅅㅋㅣㄴㅅㅡ
deutch	ㄷㅗㅇㅣㅊㅣ
louie	ㄹㅜㅇㅣ
yelena	ㅇㅖㄹㄹㅔㄴㅏ
magda	ㅁㅏㄱㅡㄷㅏ
lolita	ㄹㅗㄹㄹㅣㅌㅏ
glover	ㄱㅡㄹㄹㅓㅂㅓ
ohara	ㅇㅗㅎㅏㄹㅏ
lisbeth	ㄹㅣㅅㅡㅂㅔㅌㅡ
bacon	ㅂㅔㅇㅣㅋㅓㄴ
evangelos	ㅇㅔㅂㅏㅇㄱㅔㄹㄹㅗㅅㅡ
booth	ㅂㅜㅅㅡ
russo	ㄹㅜㅅㅗ
ginger	ㅈㅣㄴㅈㅓ
puccini	ㅍㅜㅊㅣㄴㅣ
carey	ㅋㅐㄹㅣ
elon	ㅇㅔㄹㄹㅗㄴ
fleischer	ㅍㅡㄹㄹㅏㅇㅣㅅㅕ
santamaria	ㅅㅏㄴㅌㅏㅁㅏㄹㅣㅇㅏ
ernesto	ㅇㅔㄹㅡㄴㅔㅅㅡㅌㅗ
ivi	ㅇㅣㅂㅣ
theodor	ㅌㅔㅇㅗㄷㅗㅇㅓ
jody	ㅈㅗㄷㅣ
havenaar	ㅎㅏㅍㅡㄴㅏ
phyllis	ㅍㅣㄹㄹㅣㅅㅡ
flemming	ㅍㅡㄹㄹㅔㅁㅣㅇ
hermione	ㅎㅓㅁㅏㅇㅣㅇㅗㄴㅣ
naoyoshi	ㄴㅏㅇㅗㅇㅛㅅㅣ
merrill	ㅁㅔㄹㅣㄹ
alam	ㅇㅏㄹㄹㅏㅁ
colby	ㅋㅗㄹㅂㅣ
estigarribia	ㅇㅔㅅㅡㅌㅣㄱㅏㄹㅣㅂㅣㅇㅏ
macdonald	ㅁㅐㄱㄷㅗㄴㅓㄹㄷㅡ
dias	ㄷㅣㅇㅏㅅㅡ
wahlberg	ㅇㅝㄹㅂㅓㄱㅡ
rylance	ㄹㅏㅇㅣㄹㄹㅓㄴㅅㅡ
rokkaku	ㄹㅗㅅㅋㅏㅋㅜ
luiz	ㄹㅜㅇㅣㅅㅡ
prescott	ㅍㅡㄹㅔㅅㅡㅋㅗㅅ
yoshiharu	ㅇㅛㅅㅣㅎㅏㄹㅜ
road	ㄹㅗㄷㅡ
heine	ㅎㅏㅇㅣㄴㅔ
vittoria	ㅂㅣㅌㅗㄹㅣㅇㅏ
yazdegerd	ㅇㅑㅈㅡㄷㅔㄱㅔㄹㅡㄷㅡ
moe	ㅁㅗ
den	ㄷㅔㄴ
crane	ㅋㅡㄹㅔㅇㅣㄴ
briand	ㅂㅡㄹㅣㅇㅏㅇ
marisa	ㅁㅏㄹㅣㅅㅏ
bamber	ㅂㅐㅁㅂㅓ
alessandro	ㅇㅏㄹㄹㅔㅅㅏㄴㄷㅡㄹㅗ
kirilenko	ㅋㅣㄹㅣㄹㄹㅔㄴㅋㅗ
pill	ㅍㅣㄹ
carlo	ㅋㅏㄹㅡㄹㄹㅗ
anund	ㅇㅏㄴㅜㄴㄷㅡ
vicky	ㅂㅣㅋㅣ
stefan	ㅅㅡㅌㅔㅍㅏㄴ
jeter	ㅈㅣㅌㅓ
jenn	ㅈㅔㄴ
signori	ㅅㅣㄴㅛㄹㅣ
stein	ㅅㅡㅌㅏㅇㅣㄴ
zuckerberg	ㅈㅓㅋㅓㅂㅓㄱㅡ
wanda	ㅇㅘㄴㄷㅏ
berlin	ㅂㅓㄹㄹㅣㄴ
hina	ㅎㅣㄴㅏ
taras	ㅌㅏㄹㅏㅅㅡ
sarandon	ㅅㅓㄹㅐㄴㄷㅓㄴ
mira	ㅁㅣㄹㅏ
sid	ㅅㅣㄷㅡ
bodin	ㅂㅗㄷㅐㅇ
shigetsugu	ㅅㅣㄱㅔㅆㅡㄱㅜ
sen	ㅅㅔㄴ
shinnosuke	ㅇㅏㅂㅔ
szostak	ㅅㅛㅅㅡㅌㅐㄱ
vincenzo	ㅂㅣㄴㅊㅔㄴㅊㅗ
twain	ㅌㅡㅇㅞㅇㅣㄴ
sacchi	ㅅㅏㅋㅣ
wesley	ㅇㅞㅅㅡㄹㄹㅣ
slade	ㅅㅡㄹㄹㅔㅇㅣㄷㅡ
schumacher	ㅅㅠㅁㅏㅎㅓ
naozumi	ㄴㅏㅇㅗㅈㅡㅁㅣ
arai	ㅇㅏㄹㅏㅇㅣ
bay	ㅂㅔㅇㅣ
armitage	ㅇㅏㅁㅣㅌㅣㅈㅣ
sushil	ㅅㅜㅅㅣㄹ
coady	ㅋㅗㄷㅣ
elias	ㅇㅔㄹㄹㅣㅇㅏㅅㅡ
alonzo	ㅇㅏㄹㄹㅗㄴㅈㅗ
dagobert	ㄷㅏㄱㅗㅂㅔㄹㅡㅌㅡ
tapio	ㅌㅏㅍㅣㅇㅗ
fernanda	ㅍㅔㄹㅡㄴㅏㄴㄷㅏ
bridges	ㅂㅡㄹㅣㅈㅣㅅㅡ
reiter	ㄹㅏㅇㅣㅌㅓ
hattori	ㅎㅏㅅㅌㅗㄹㅣ
jennifer	ㅈㅔㄴㅣㅍㅓ
costello	ㅋㅗㅅㅡㅌㅔㄹㄹㅗ
emerald	ㅇㅔㅁㅔㄹㅏㄹㄷㅡ
yasumasa	ㅇㅑㅅㅡㅁㅏㅅㅏ
uchida	ㅇㅜㅊㅣㄷㅏ
dorothy	ㄷㅗㄹㅗㅅㅣ
monet	ㅁㅗㄴㅔ
head	ㅎㅔㄷㅡ
bird	ㅂㅓㄷㅡ
kelsey	ㅋㅔㄹㅅㅣ
mansfield	ㅁㅐㄴㅅㅡㅍㅣㄹㄷㅡ
vanessa	ㅂㅓㄴㅔㅅㅏ
longo	ㄹㅗㅇㄱㅗ
knud	ㅋㅡㄴㅜㄷㅡ
lindh	ㄹㅣㄴㄷㅡ
gunnar	ㄱㅜㄴㄴㅏㄹㅡ
boom	ㅂㅜㅁ
darling	ㄷㅏㄹㄹㅣㅇ
elin	ㅇㅔㄹㄹㅣㄴ
mehdi	ㅁㅔㄷㅣ
hoshina	ㅎㅗㅅㅣㄴㅏ
diouf	ㄷㅣㅇㅜㅍㅡ
levan	ㄹㅔㅂㅏㄴ
berkoff	ㅂㅓㅋㅗㅍㅡ
gal	ㄱㅏㄹ
jed	ㅈㅔㄷㅡ
mansor	ㅁㅏㄴㅅㅗㄹㅡ
ford	ㅍㅗㄷㅡ
ferdinand	ㅍㅔㄹㅡㄷㅣㄴㅏㄴㅌㅡ
tucker	ㅌㅓㅋㅓ
yost	ㅇㅛㅅㅡㅌㅡ
hatcher	ㅎㅐㅊㅓ
rachael	ㄹㅔㅇㅣㅊㅓㄹ
snow	ㅅㅡㄴㅗ
cohn	ㅋㅗㄴ
reitman	ㄹㅏㅇㅣㅌㅡㅁㅓㄴ
narendra	ㄴㅏㄹㅔㄴㄷㅡㄹㅏ
dallas	ㄷㅐㄹㄹㅓㅅㅡ
izzy	ㅇㅣㅈㅣ
zandi	ㅈㅏㄴㄷㅣ
markov	ㅁㅏㄹㅡㅋㅗㅍㅡ
tomei	ㅌㅗㅁㅔㅇㅣ
roxanne	ㄹㅗㄱㅅㅏㄴㄴㅡ
amaro	ㅇㅏㅁㅏㄹㅗ
tsunashige	ㅆㅡㄴㅏㅅㅣㄱㅔ
sergey	ㅅㅔㄹㅡㄱㅔㅇㅣ
bush	ㅂㅜㅅㅣ
rekha	ㄹㅔㅋㅏ
bartoli	ㅂㅏㄹㅡㅌㅗㄹㄹㅣ
tisdale	ㅌㅣㅅㅡㄷㅔㅇㅣㄹ
dimitar	ㄷㅣㅁㅣㅌㅏㄹㅡ
lizzy	ㄹㅣㅈㅣ
juliana	ㅈㅜㄹㄹㅣㅇㅏㄴㅏ
claire	ㅋㅡㄹㄹㅔㅇㅓ
karakatsanis	ㅋㅏㄹㅏㅋㅏㅊㅏㄴㅣㅅㅡ
uri	ㅇㅠㄹㅣ
dianne	ㄷㅏㅇㅣㅇㅐㄴ
moreira	ㅁㅗㄹㅔㅇㅣㄹㅏ
arkady	ㅇㅏㄹㅡㅋㅏㄷㅣ
bert	ㅂㅓㅌㅡ
richmond	ㄹㅣㅊㅣㅁㅓㄴㄷㅡ
kristal	ㅋㅡㄹㅣㅅㅡㅌㅏㄹ
bright	ㅂㅡㄹㅏㅇㅣㅌㅡ
siegbahn	ㅅㅣㄱㅡㅂㅏㄴ
paltrow	ㅍㅐㄹㅌㅡㄹㅗ
cary	ㅋㅐㄹㅣ
doi	ㄷㅗㅇㅣ
kadyrov	ㅋㅏㄷㅣㄹㅗㅍㅡ
keller	ㅋㅔㄹㄹㅓ
nano	ㄴㅏㄴㅗ
mubarak	ㅁㅜㅂㅏㄹㅏㅋㅡ
christopher	ㅋㅡㄹㅣㅅㅡㅌㅗㅍㅓ
parker	ㅍㅏㅋㅓ
talorc	ㅌㅏㄹㄹㅗㄹㅡㅋㅡ
frankie	ㅍㅡㄹㅐㅇㅋㅣ
chin	ㅊㅣㄴ
atahualpa	ㅇㅏㅌㅏㅇㅜㅇㅏㄹㅍㅏ
nobushige	ㄴㅗㅂㅜㅅㅣㄱㅔ
jordan	ㅈㅗㄷㅓㄴ
archuleta	ㅇㅏㅊㅜㄹㄹㅔㅌㅏ
pinto	ㅍㅣㄴㅌㅗ
lucy	ㄹㅜㅅㅣ
konoe	ㄱㅗㄴㅗㅇㅔ
unger	ㅇㅓㅇㄱㅓ
colombo	ㅋㅗㄹㄹㅗㅁㅂㅗ
wilkes	ㅇㅟㄹㅋㅡㅅㅡ
mcnamara	ㅁㅐㄱㄴㅏㅁㅏㄹㅏ
tandy	ㅌㅐㄴㄷㅣ
earle	ㅇㅓㄹ
khamis	ㅋㅏㅁㅣㅅㅡ
orlandi	ㅇㅗㄹㅡㄹㄹㅏㄴㄷㅣ
zweig	ㅊㅡㅂㅏㅇㅣㅋㅡ
horowitz	ㅎㅗㄹㅗㅂㅣㅊㅡ
clarice	ㅋㅡㄹㄹㅏㄹㅣㅊㅔ
karl	ㅋㅏㄹㅡㄹ
allende	ㅇㅏㅇㅖㄴㄷㅔ
macfarlane	ㅁㅐㄱㅍㅏㄹㄹㅔㅇㅣㄴ
engelbert	ㅇㅔㅇㄱㅔㄹㅂㅔㄹㅡㅌㅡ
eva	ㅇㅔㅂㅏ
mulder	ㅁㅟㄹㄷㅓㄹㅡ
stuhr	ㅅㅡㅌㅜㅎㅡㄹㅡ
aleksandar	ㅇㅏㄹㄹㅔㄱㅅㅏㄴㄷㅏㄹㅡ
schell	ㅅㅖㄹ
reinhard	ㄹㅏㅇㅣㄴㅎㅏㄹㅡㅌㅡ
gia	ㅈㅣㅇㅏ
mika	ㅁㅣㅋㅏ
akizuki	ㅇㅏㅋㅣㅈㅡㅋㅣ
maher	ㅁㅏ
guthrie	ㄱㅓㅅㅡㄹㅣ
macdowell	ㅁㅐㄱㄷㅗㅇㅞㄹ
hoffmann	ㅎㅗㅍㅡㅁㅏㄴ
nikolayeva	ㄴㅣㅋㅗㄹㄹㅏㅇㅖㅂㅏ
julianne	ㅈㅜㄹㄹㅣㅇㅐㄴ
marcello	ㅁㅏㄹㅡㅊㅔㄹㄹㅗ
singleton	ㅅㅣㅇㄱㅡㄹㅌㅓㄴ
armando	ㅇㅏㄹㅡㅁㅏㄴㄷㅗ
armstrong	ㅇㅏㅁㅅㅡㅌㅡㄹㅗㅇ
jana	ㅇㅑㄴㅏ
fiona	ㅍㅣㅇㅗㄴㅏ
gottlieb	ㄱㅗㅌㅡㄹㄹㅣㅍㅡ
sengupta	ㅅㅔㅇㄱㅜㅂㅌㅏ
durant	ㄷㅠㄹㅐㄴㅌㅡ
vassili	ㅂㅏㅅㅣㄹㄹㅣ
tallulah	ㅌㅏㄹㄹㅜㄹㄹㅏ
sadowski	ㅅㅏㄷㅗㅅㅡㅋㅣ
frei	ㅍㅡㄹㅏㅇㅣ
lefebvre	ㄹㅡㅍㅔㅂㅡㄹㅡ
passos	ㅍㅏㅅㅜㅅㅡ
dee	ㄷㅣ
sasha	ㅅㅏㅅㅑ
mukherjee	ㅁㅜㅋㅔㄹㅡㅈㅣ
tanaka	ㅁㅣㅋㅜ
mantovani	ㅁㅏㄴㅌㅗㅂㅏㄴㅣ
fuller	ㅍㅜㄹㄹㅓ
clyne	ㅋㅡㄹㄹㅏㅇㅣㄴ
figueroa	ㅍㅣㄱㅔㄹㅗㅇㅏ
ali	ㅇㅏㄹㄹㅣ
finney	ㅍㅣㄴㅣ
emmerich	ㅇㅔㅁㅓㄹㅣㅎㅣ
renato	ㅎㅔㄴㅏㅌㅜ
baresi	ㅂㅏㄹㅔㅅㅣ
buck	ㅂㅓㄱ
marilyn	ㅁㅔㄹㅣㄹㄹㅣㄴ
goldsworthy	ㄱㅗㄹㅈㅡㅇㅝㄷㅣ
lennart	ㄹㅔㄴㅏㄹㅡㅌㅡ
hamilton	ㅎㅐㅁㅣㄹㅌㅓㄴ
koskela	ㅋㅗㅅㅡㅋㅔㄹㄹㅏ
schmitt	ㅅㅠㅁㅣㅅ
huxley	ㅎㅓㄱㅅㅡㄹㄹㅣ
simona	ㅅㅣㅁㅗㄴㅏ
tadateru	ㄷㅏㄷㅏㅌㅔㄹㅜ
barrett	ㅂㅐㄹㅓㅅ
asher	ㅇㅐㅅㅕ
polito	ㅍㅗㄹㄹㅣㅌㅗ
ashley	ㅇㅐㅅㅠㄹㄹㅣ
mark	ㅁㅏㅋㅡ
eddie	ㅇㅔㄷㅣ
burrell	ㅂㅓㄹㅔㄹ
mosley	ㅁㅗㅈㅡㄹㄹㅣ
niemi	ㄴㅣㅇㅔㅁㅣ
nile	ㄴㅏㅇㅣㄹ
lowe	ㄹㅗ
whitman	ㅎㅟㅌㅡㅁㅓㄴ
nicola	ㄴㅣㅋㅗㄹㄹㅏ
eddy	ㅇㅔㄷㅣ
gable	ㄱㅔㅇㅣㅂㅡㄹ
caterina	ㅋㅏㅌㅔㄹㅣㄴㅏ
mina	ㅁㅣㄴㅏ
chanel	ㅅㅑㄴㅔㄹ
cartwright	ㅋㅏㅌㅡㄹㅏㅇㅣㅌㅡ
ramazzotti	ㄹㅏㅁㅏㅊㅗㅌㅣ
t	ㅌㅣ
khalid	ㅎㅏㄹㄹㅣㄷㅡ
heiberg	ㅎㅔㅇㅣㅂㅔㄹㅡ
susanne	ㅅㅜㅅㅏㄴㄴㅔ
jeanne	ㅈㅏㄴ
hassan	ㅎㅏㅅㅏㄴ
patricia	ㅍㅓㅌㅡㄹㅣㅅㅑ
hasler	ㅎㅏㅅㅡㄹㄹㅓ
felice	ㅍㅔㄹㄹㅣㅊㅔ
gilgun	ㄱㅣㄹㄱㅓㄴ
golding	ㄱㅗㄹㄷㅣㅇ
willard	ㅇㅟㄹㄹㅓㄷㅡ
zak	ㅈㅐㄱ
russ	ㄹㅜㅅㅡ
bissell	ㅂㅣㅅㅔㄹ
bondarchuk	ㅂㅗㄴㄷㅏㄹㅡㅊㅜㅋㅡ
jorma	ㅇㅛㄹㅡㅁㅏ
schweiger	ㅅㅠㅂㅏㅇㅣㄱㅓ
ilmari	ㅇㅣㄹㅁㅏㄹㅣ
stanton	ㅅㅡㅌㅐㄴㅌㅓㄴ
wayans	ㅇㅞㅇㅣㅇㅓㄴㅅㅡ
lopes	ㄹㅗㅍㅔㅅㅡ
darryl	ㄷㅐㄹㅣㄹ
ahmed	ㅇㅏㅁㅔㄷㅡ
ivory	ㅇㅏㅇㅣㅂㅗㄹㅣ
yedlin	ㅇㅖㄷㅡㄹㄹㅣㄴ
daphne	ㄷㅏㅍㅡㄴㅔ
filippo	ㅍㅣㄹㄹㅣㅍㅗ
zara	ㅈㅏㄹㅏ
reinhart	ㄹㅏㅇㅣㄴㅎㅏㅌㅡ
annie	ㅇㅐㄴㅣ
gottfried	ㄱㅗㅌㅡㅍㅡㄹㅣㅌㅡ
ben	ㅂㅔㄴ
natalya	ㄴㅏㅌㅏㄹㄹㅣㅇㅑ
waters	ㅇㅝㅌㅓㅅㅡ
jill	ㅈㅣㄹ
weisz	ㅂㅏㅇㅣㅅㅡ
faris	ㅍㅐㄹㅣㅅㅡ
visser	ㅍㅣㅅㅓㄹㅡ
dana	ㄷㅔㅇㅣㄴㅏ
victoria	ㅂㅣㄱㅌㅗㄹㅣㅇㅏ
pia	ㅍㅣㅇㅏ
pileser	ㅍㅣㄹㄹㅔㅅㅔㄹㅡ
shun	ㄷㅏㅋㅏㄱㅣ
xenia	ㅋㅡㅅㅔㄴㅣㅇㅏ
ivo	ㅇㅣㅂㅗ
anastasio	ㅇㅏㄴㅏㅅㅡㅌㅏㅅㅣㅇㅗ
rico	ㄹㅣㅋㅗ
neferkare	ㄴㅔㅍㅔㄹㅡㅋㅏㄹㅔ
rashida	ㄹㅏㅅㅣㄷㅏ
nabil	ㄴㅏㅂㅣㄹ
bohdan	ㅂㅗㅎㅡㄷㅏㄴ
coke	ㅋㅗㅋㅡ
schuyler	ㅅㅡㅋㅏㅇㅣㄹㄹㅓ
mazza	ㅁㅏㅅㅏ
rudi	ㄹㅜㄷㅣ
thicke	ㅅㅣㅋㅡ
freddie	ㅍㅡㄹㅔㄷㅣ
jermaine	ㅈㅓㅁㅔㅇㅣㄴ
lopez	ㄹㅗㅍㅔㅈㅡ
bedford	ㅂㅔㄷㅡㅍㅗㄷㅡ
quintus	ㅋㅟㄴㅌㅜㅅㅡ
peg	ㅍㅔㄱㅡ
napolitano	ㄴㅏㅍㅗㄹㄹㅣㅌㅏㄴㅗ
zoran	ㅈㅗㄹㅏㄴ
machado	ㅁㅏㅅㅑㄷㅜ
montefeltro	ㅁㅗㄴㅌㅔㅍㅔㄹㅌㅡㄹㅗ
whitmore	ㅇㅟㅌㅡㅁㅗㅇㅓ
christos	ㅎㅡㄹㅣㅅㅡㅌㅗㅅㅡ
balboa	ㅂㅏㄹㅂㅗㅇㅏ
artemio	ㅇㅏㄹㅡㅌㅔㅁㅣㅇㅗ
wilde	ㅇㅘㅇㅣㄹㄷㅡ
spano	ㅅㅡㅍㅏㄴㅗ
kingsley	ㅋㅣㅇㅈㅡㄹㄹㅣ
costa	ㅋㅗㅅㅡㅌㅏ
morishita	ㅎㅣㅌㅗㅅㅣ
lister	ㄹㅣㅅㅡㅌㅓ
anderson	ㅇㅐㄴㄷㅓㅅㅡㄴ
lucius	ㄹㅜㅋㅣㅇㅜㅅㅡ
rubio	ㄹㅜㅂㅣㅇㅗ
maxim	ㅁㅏㄱㅅㅣㅁ
halil	ㅎㅏㄹㄹㅣㄹ
hansen	ㅎㅏㄴㅅㅔㄴ
mahi	ㅁㅏㅎㅣ
muti	ㅁㅜㅌㅣ
cochrane	ㅋㅗㅋㅡㄹㅔㅇㅣㄴ
murat	ㅁㅜㄹㅏㅌㅡ
romney	ㄹㅗㅁㄴㅣ
barnard	ㅂㅓㄴㅏㄷㅡ
insigne	ㅇㅣㄴㅅㅣㄴㅖ
ivy	ㅇㅏㅇㅣㅂㅣ
burke	ㅂㅓㅋㅡ
farrow	ㅍㅐㄹㅗ
ken	ㅋㅔㄴ
fabiana	ㅍㅏㅂㅣㅇㅏㄴㅏ
beltrami	ㅂㅔㄹㅌㅡㄹㅏㅁㅣ
huntington	ㅎㅓㄴㅌㅣㅇㅌㅓㄴ
milo	ㅁㅏㅇㅣㄹㄹㅗ
casanova	ㅋㅏㅅㅏㄴㅗㅂㅏ
berruti	ㅂㅔㄹㅜㅌㅣ
ziegler	ㅊㅣㄱㅡㄹㄹㅓ
akamatsu	ㅇㅏㅋㅏㅁㅏㅊㅡ
weber	ㅂㅔㅂㅓ
kadir	ㅋㅏㄷㅣㄹㅡ
harada	ㅎㅏㄹㅏㄷㅏ
meier	ㅁㅏㅇㅣㅇㅓ
jesper	ㅇㅖㅅㅡㅍㅔ
bamba	ㅂㅏㅁㅂㅏ
ashmore	ㅇㅐㅅㅠㅁㅗㅇㅓ
lombard	ㄹㅗㅁㅂㅏㄷㅡ
fumika	ㅅㅣㅁㅣㅈㅡ
sabrina	ㅅㅏㅂㅡㄹㅣㄴㅏ
rick	ㄹㅣㄱ
beer	ㅂㅣㅇㅓ
hussein	ㅎㅜㅅㅔㅇㅣㄴ
belo	ㅂㅔㄹㄹㅜ
gyllenhaal	ㅈㅣㄹㄹㅓㄴㅎㅗㄹ
ville	ㅂㅣㄹㄹㅔ
ekaterina	ㅇㅖㅋㅏㅌㅔㄹㅣㄴㅏ
patti	ㅍㅐㅌㅣ
khalfan	ㅋㅏㄹㅍㅏㄴ
declan	ㄷㅣㅋㅡㄹㄹㅐㄴ
leila	ㄹㅔㅇㅣㄹㄹㅏ
clifford	ㅋㅡㄹㄹㅣㅍㅓㄷㅡ
yukitaka	ㅇㅠㅋㅣㅌㅏㅋㅏ
kirk	ㅋㅓㅋㅡ
ion	ㅇㅣㅇㅗㄴ
gibson	ㄱㅣㅂㅅㅡㄴ
tupou	ㅌㅜㅍㅗㅇㅜ
akechi	ㅇㅏㅋㅔㅊㅣ
kitagawa	ㄱㅣㅌㅏㄱㅏㅇㅘ
napoleon	ㄴㅏㅍㅗㄹㄹㅔㅇㅗㅇ
jens	ㅇㅖㄴㅅㅡ
jigme	ㅈㅣㄱㅡㅁㅔ
zasulich	ㅈㅏㅅㅜㄹㄹㅣㅊㅣ
steinmetz	ㅅㅡㅌㅏㅇㅣㄴㅁㅔㅊㅡ
astin	ㅇㅐㅅㅡㅌㅣㄴ
tiago	ㅌㅣㅇㅏㄱㅗ
nikolopoulos	ㄴㅣㅋㅗㄹㄹㅗㅍㅜㄹㄹㅗㅅㅡ
riggs	ㄹㅣㄱㅅㅡ
gregorio	ㄱㅡㄹㅔㄱㅗㄹㅣㅇㅗ
slobodan	ㅅㅡㄹㄹㅗㅂㅗㄷㅏㄴ
rinat	ㄹㅣㄴㅏㅌㅡ
brand	ㅂㅡㄹㅐㄴㄷㅡ
mikaela	ㅁㅣㅋㅏㅇㅔㄹㄹㅏ
seinfeld	ㅅㅏㅇㅣㄴㅍㅔㄹㄷㅡ
laia	ㄹㅏㅇㅣㅇㅏ
fegelein	ㅍㅔㄱㅔㄹㄹㅏㅇㅣㄴ
zsa	ㅈㅏ
greer	ㄱㅡㄹㅣㅇㅓ
cameron	ㅋㅐㅁㅓㄹㅓㄴ
wanyan	ㅇㅘㄴㅇㅑㄴ
siri	ㅅㅣㄹㅣ
zappas	ㅈㅏㅍㅏㅅㅡ
mann	ㅁㅐㄴ
traylor	ㅌㅡㄹㅔㅇㅣㄹㄹㅓ
takashi	ㅅㅏㅇㅣㅌㅗ
bolt	ㅂㅗㄹㅌㅡ
miki	ㅁㅣㅋㅣ
spence	ㅅㅡㅍㅔㄴㅅㅡ
papa	ㅍㅏㅍㅏ
robson	ㄹㅗㅂㅅㅡㄴ
rance	ㄹㅐㄴㅅㅡ
rajiv	ㄹㅏㅈㅣㅂㅡ
correa	ㅋㅗㄹㅔㅇㅏ
henning	ㅎㅔㄴㅣㅇ
hanazono	ㅊㅓㄴㅎㅘㅇ
emmy	ㅇㅔㅁㅣ
cruz	ㅋㅡㄹㅜㅈㅡ
hackman	ㅎㅐㅋㅡㅁㅓㄴ
marquand	ㅁㅏㅋㅝㄴㄷㅡ
ricci	ㄹㅣㅊㅣ
hyman	ㅎㅏㅇㅣㅁㅓㄴ
ota	ㅇㅗㅌㅏ
ptolemy	ㅍㅡㅌㅗㄹㄹㅔㅁㅏㅇㅣㅇㅗㅅㅡ
cutler	ㅋㅓㅌㅡㄹㄹㅓ
pavan	ㅍㅏㅂㅏㄴ
winfield	ㅇㅟㄴㅍㅣㄹㄷㅡ
lorena	ㄹㅗㄹㅔㄴㅏ
girardot	ㅈㅣㄹㅏㄹㅡㄷㅗ
helmuth	ㅎㅔㄹㅁㅜㅌㅡ
magic	ㅁㅐㅈㅣㄱ
mistral	ㅁㅣㅅㅡㅌㅡㄹㅏㄹ
istrefi	ㅇㅣㅅㅡㅌㅡㄹㅔㅍㅣ
michael	ㅁㅏㅇㅣㅋㅡㄹ
kate	ㅋㅔㅇㅣㅌㅡ
hoare	ㅎㅗㅇㅓ
connie	ㅋㅗㄴㅣ
gourcuff	ㄱㅜㄹㅡㅋㅟㅍㅡ
scavenius	ㅅㅡㅋㅏㅂㅔㄴㅣㅇㅜㅅㅡ
grainger	ㄱㅡㄹㅔㅇㅣㄴㅈㅓ
hughes	ㅎㅠㅅㅡ
elsie	ㅇㅔㄹㅅㅣ
horikawa	ㅊㅓㄴㅎㅘㅇ
nicholas	ㄴㅣㅋㅓㄹㄹㅓㅅㅡ
sanz	ㅅㅏㄴㅅㅡ
kombarov	ㅋㅗㅁㅂㅏㄹㅗㅍㅡ
mohammed	ㅁㅗㅎㅏㅁㅔㄷㅡ
liddell	ㄹㅣㄷㅔㄹ
shea	ㅅㅣㅇㅓ
nunn	ㄴㅓㄴ
warren	ㅇㅝㄹㅓㄴ
winn	ㅇㅟㄴ
june	ㅈㅜㄴ
matt	ㅁㅐㅅ
gray	ㄱㅡㄹㅔㅇㅣ
dolby	ㄷㅗㄹㅂㅣ
sansone	ㅅㅏㄴㅅㅗㄴㅔ
daniele	ㄷㅏㄴㅣㅇㅔㄹㄹㅔ
leonov	ㄹㅔㅇㅗㄴㅗㅍㅡ
blanca	ㅂㅡㄹㄹㅏㅇㅋㅏ
khedira	ㅋㅔㄷㅣㄹㅏ
cynthia	ㅅㅣㄴㅅㅣㅇㅏ
gwendoline	ㄱㅡㅇㅞㄴㄷㅗㄹㄹㅣㄴ
tahir	ㅌㅏㅎㅣㄹㅡ
asakura	ㅇㅏㅅㅏㅋㅜㄹㅏ
storm	ㅅㅡㅌㅗㅁ
swayze	ㅅㅡㅇㅞㅇㅣㅈㅣ
danica	ㄷㅐㄴㅣㅋㅏ
ferri	ㅍㅔㄹㅣ
aemilius	ㅇㅏㅇㅣㅁㅣㄹㄹㅣㅇㅜㅅㅡ
mathew	ㅁㅐㅅㅠ
ferrell	ㅍㅔㄹㅓㄹ
nobuyuki	ㄴㅗㅂㅜㅇㅠㅋㅣ
nikita	ㄴㅣㅋㅣㅌㅏ
andranik	ㅇㅏㄴㄷㅡㄹㅏㄴㅣㅋㅡ
hikichi	ㅇㅠㅇㅑ
danson	ㄷㅐㄴㅅㅡㄴ
paradis	ㅍㅏㄹㅏㄷㅣ
joanne	ㅈㅗㅇㅐㄴ
leigh	ㄹㅣ
mura	ㅁㅜㄹㅏ
townshend	ㅌㅗㄴㅈㅔㄴㄷㅡ
owen	ㅇㅗㅇㅓㄴ
noel	ㄴㅗㅇㅔㄹ
henry	ㅎㅔㄴㄹㅣ
leonor	ㄹㅔㅇㅗㄴㅗㄹㅡ
shamir	ㅅㅑㅁㅣㄹㅡ
arnaz	ㅇㅏㄴㅓㅈㅡ
domingo	ㄷㅗㅁㅣㅇㄱㅗ
shipp	ㅅㅣㅂ
amaia	ㅇㅏㅁㅏㅇㅣㅇㅏ
alexy	ㅇㅏㄹㄹㅔㄱㅅㅣ
glenn	ㄱㅡㄹㄹㅔㄴ
nia	ㄴㅣㅇㅏ
peggy	ㅍㅔㄱㅣ
palma	ㅍㅏㄹㅁㅏ
manaudou	ㅁㅏㄴㅗㄷㅜ
wes	ㅇㅞㅅㅡ
rueda	ㄹㅜㅇㅔㄷㅏ
tsukamoto	ㄷㅏㅋㅏㅅㅣ
viktoria	ㅂㅣㄱㅌㅗㄹㅣㅇㅏ
schiaparelli	ㅅㅡㅋㅣㅇㅏㅍㅏㄹㅔㄹㄹㅣ
esther	ㅇㅔㅅㅡㄷㅓ
kenny	ㅋㅔㄴㅣ
eleanor	ㅇㅔㄹㄹㅣㄴㅓ
medina	ㅁㅔㄷㅣㄴㅏ
parisot	ㅍㅐㄹㅣㅅㅗ
benny	ㅂㅔㄴㅣ
felicity	ㅍㅔㄹㄹㅣㅅㅣㅌㅣ
lam	ㄹㅏㅁ
kiko	ㅋㅣㅋㅗ
lo	ㄹㅗ
natalia	ㄴㅏㅌㅏㄹㄹㅣㅇㅏ
kendrick	ㅋㅔㄴㄷㅡㄹㅣㄱ
stephenson	ㅅㅡㅌㅣㅂㅡㄴㅅㅡㄴ
toivo	ㅌㅗㅇㅣㅂㅗ
amos	ㅇㅏㅁㅗㅅㅡ
adrianne	ㅇㅔㅇㅣㄷㅡㄹㅣㅇㅓㄴ
macleod	ㅁㅐㅋㅡㄹㄹㅏㅇㅜㄷㅡ
cartan	ㅋㅏㄹㅡㅌㅏㅇ
zuzana	ㅈㅜㅈㅏㄴㅏ
bone	ㅂㅗㄴ
webster	ㅇㅞㅂㅅㅡㅌㅓ
haile	ㅎㅏㅇㅣㄹㄹㅔ
simons	ㅅㅣㅁㅗㄴㅅㅡ
richie	ㄹㅣㅊㅣ
bernoulli	ㅂㅔㄹㅡㄴㅜㅇㅣ
bender	ㅂㅔㄴㄷㅓ
kushihashi	ㅋㅜㅅㅣㅎㅏㅅㅣ
grier	ㄱㅡㄹㅣㅇㅓ
tamblyn	ㅌㅐㅁㅂㅡㄹㄹㅣㄴ
tancharoen	ㅌㅐㄴㅊㅓㄹㅗㄴ
klerk	ㅋㅡㄹㄹㅔㄹㅡㅋㅡ
salman	ㅅㅏㄹㅁㅏㄴ
regina	ㄹㅔㅈㅣㄴㅏ
janice	ㅈㅐㄴㅣㅅㅡ
tito	ㅌㅣㅌㅗ
dempsey	ㄷㅔㅁㅍㅡㅅㅣ
rich	ㄹㅣㅊㅣ
linn	ㄹㅣㄴ
masato	ㅇㅑㅁㅏㅈㅏㅋㅣ
keegan	ㅋㅣㄱㅓㄴ
gates	ㄱㅔㅇㅣㅊㅡ
shiflett	ㅅㅣㅍㅡㄹㅔㅅ
amr	ㅇㅏㅁㅡㄹㅡ
milne	ㅁㅣㄹㄹㅡㄴ
zach	ㅈㅐㄱ
sabin	ㅅㅔㅇㅣㅂㅣㄴ
lili	ㄹㅣㄹㄹㅣ
hampson	ㅎㅐㅁㅍㅡㅅㅡㄴ
gabriella	ㄱㅏㅂㅡㄹㅣㅇㅔㄹㄹㅏ
hazard	ㅇㅏㅈㅏㄹㅡ
aksana	ㅇㅏㄱㅅㅏㄴㅏ
cabral	ㅋㅏㅂㅡㄹㅏㄹ
libor	ㄹㅣㅂㅗㄹㅡ
madsen	ㅁㅏㅅㅔㄴ
yoshitatsu	ㅇㅛㅅㅣㅌㅏㅆㅡ
abraham	ㅇㅔㅇㅣㅂㅡㄹㅓㅎㅐㅁ
asia	ㅇㅏㅅㅣㅇㅏ
wall	ㅇㅝㄹ
hargitay	ㅎㅏㄱㅣㅌㅔㅇㅣ
pessoa	ㅍㅔㅅㅗㅇㅏ
perez	ㅍㅔㄹㅔㅅㅡ
jayne	ㅈㅔㅇㅣㄴ
baldomero	ㅂㅏㄹㄷㅗㅁㅔㄹㅗ
reginald	ㄹㅔㅈㅣㄴㅓㄹㄷㅡ
behring	ㅂㅔㄹㅣㅇ
aliona	ㅇㅏㄹㄹㅣㅇㅗㄴㅏ
farhad	ㅍㅏㅎㅏㄷㅡ
masi	ㅁㅏㅅㅣ
marina	ㅁㅏㄹㅣㄴㅏ
sanabria	ㅅㅏㄴㅏㅂㅡㄹㅣㅇㅏ
herrera	ㅇㅔㄹㅔㄹㅏ
mays	ㅁㅔㅇㅣㅅㅡ
marquette	ㅁㅏㅋㅔㅅ
rodgers	ㄹㅗㅈㅓㅅㅡ
hoarau	ㅇㅗㅇㅏㄹㅗ
tommaso	ㅌㅗㅁㅁㅏㅅㅗ
schreiber	ㅅㅠㄹㅏㅇㅣㅂㅓ
michel	ㅁㅣㅅㅖㄹ
boniperti	ㅂㅗㄴㅣㅍㅔㄹㅡㅌㅣ
hatta	ㅎㅏㅌㅏ
beckett	ㅂㅔㅋㅔㅅ
macedo	ㅁㅏㅅㅔㄷㅜ
fromm	ㅍㅡㄹㅗㅁ
hero	ㅎㅣㅇㅓㄹㅗ
morais	ㅁㅗㄹㅏㅇㅣㅅㅡ
shawn	ㅅㅛㄴ
tatsuya	ㅅㅡㅈㅡㅋㅣ
wright	ㄹㅏㅇㅣㅌㅡ
prasad	ㅍㅡㄹㅏㅅㅏㄷㅡ
anamaria	ㅇㅏㄴㅏㅁㅏㄹㅣㅇㅏ
lamas	ㄹㅏㅁㅏㅅㅡ
alia	ㅇㅏㄹㄹㅣㅇㅏ
kadlec	ㅋㅏㄷㅡㄹㄹㅔㅊㅡ
wilkinson	ㅇㅟㄹㅋㅣㄴㅅㅡㄴ
tena	ㅌㅔㄴㅏ
sarah	ㅅㅔㄹㅏ
gibbons	ㄱㅣㅂㅓㄴㅅㅡ
brolin	ㅂㅡㄹㅗㄹㄹㅣㄴ
emanuel	ㅇㅔㅁㅏㄴㅜㅇㅔㄹ
dany	ㄷㅏㄴㅣ
yoshino	ㅎㅣㄹㅗㅇㅠㅋㅣ
reza	ㄹㅔㅈㅏ
mariana	ㅁㅏㄹㅣㅇㅏㄴㅏ
warnock	ㅇㅝㄴㅗㄱ
artem	ㅇㅏㄹㅡㅌㅔㅁ
bilal	ㅂㅣㄹㄹㅏㄹ
ingrid	ㅇㅣㅇㄱㅡㄹㅣㄷㅡ
brianna	ㅂㅡㄹㅣㅇㅐㄴㅏ
lise	ㄹㅣㅅㅔ
stoyanov	ㅅㅡㅌㅗㅇㅑㄴㅗㅍㅡ
ritchie	ㄹㅣㅊㅣ
elizondo	ㅇㅔㄹㄹㅣㅅㅗㄴㄷㅗ
publius	ㅍㅜㅂㅡㄹㄹㅣㅇㅜㅅㅡ
meijer	ㅁㅏㅇㅣㅇㅓ
iqbal	ㅇㅣㅋㅡㅂㅏㄹ
sulla	ㅅㅜㄹㄹㅏ
kean	ㅋㅣㄴ
drew	ㄷㅡㄹㅜ
oleary	ㅇㅗㄹㅣㅇㅓㄹㅣ
dinah	ㄷㅣㄴㅏ
wyman	ㅇㅘㅇㅣㅁㅓㄴ
campo	ㅋㅏㅁㅍㅗ
junya	ㄷㅏㄴㅏㅋㅏ
hope	ㅎㅗㅍㅡ
dinas	ㄷㅣㄴㅏㅅㅡ
groves	ㄱㅡㄹㅗㅂㅡㅅㅡ
vespucci	ㅂㅔㅅㅡㅍㅜㅊㅣ
mcgill	ㅁㅐㄱㄱㅣㄹ
jack	ㅈㅐㄱ
kara	ㅋㅏㄹㅏ
farnese	ㅍㅏㄹㅡㄴㅔㅅㅔ
drexler	ㄷㅡㄹㅔㄱㅅㅡㄹㄹㅓ
olav	ㅇㅗㄹㄹㅏㅂㅡ
carson	ㅋㅏㅅㅡㄴ
renner	ㄹㅔㄴㅓ
olin	ㅇㅗㄹㄹㅣㄴ
ray	ㄹㅔㅇㅣ
gerrard	ㅈㅔㄹㅏㄷㅡ
blanco	ㅂㅡㄹㄹㅏㅇㅋㅗ
jesse	ㅈㅔㅅㅣ
esha	ㅇㅔㅅㅑ
duffield	ㄷㅓㅍㅣㄹㄷㅡ
horst	ㅎㅗㄹㅡㅅㅡㅌㅡ
antonescu	ㅇㅏㄴㅌㅗㄴㅔㅅㅡㅋㅜ
barbosa	ㅂㅏㄹㅡㅂㅗㅈㅏ
yoann	ㅇㅛㅇㅏㄴ
erceg	ㅇㅔㄹㅡㅊㅔㄱㅡ
isabelle	ㅇㅣㅈㅏㅂㅔㄹ
hawkins	ㅎㅗㅋㅣㄴㅅㅡ
adami	ㅇㅏㄷㅏㅁㅣ
gabel	ㄱㅏㅂㅔㄹ
meena	ㅁㅣㄴㅏ
kinney	ㅋㅣㄴㅣ
ling	ㄹㅣㅇ
john	ㅈㅗㄴ
silvana	ㅅㅣㄹㅂㅏㄴㅏ
sani	ㅅㅏㄴㅣ
philipp	ㅍㅣㄹㄹㅣㅍㅡ
alencar	ㅇㅏㄹㄹㅔㅇㅋㅏㄹㅡ
gross	ㄱㅡㄹㅗㅅㅡ
der	ㄷㅔㄹㅡ
johnston	ㅈㅗㄴㅅㅡㅌㅓㄴ
ishikawa	ㅇㅣㅅㅣㅋㅏㅇㅘ
yves	ㅇㅣㅂㅡ
windom	ㅇㅟㄴㄷㅓㅁ
djibril	ㅈㅣㅂㅡㄹㅣㄹ
adkins	ㅇㅐㄷㅡㅋㅣㄴㅅㅡ
kathy	ㅋㅐㅅㅣ
erik	ㅇㅔㄹㅣㄱ
elisha	ㅇㅔㄹㄹㅣㅅㅑ
ginsberg	ㄱㅣㄴㅈㅡㅂㅓㄱㅡ
dayne	ㄷㅔㅇㅣㄴ
goebbels	ㄱㅚㅂㅔㄹㅅㅡ
ribeiro	ㅎㅣㅂㅔㅇㅣㄹㅜ
witold	ㅂㅣㅌㅗㄹㅌㅡ
mos	ㅁㅗㅅㅡ
salvatore	ㅅㅏㄹㅂㅏㅌㅗㄹㅔ
duffy	ㄷㅓㅍㅣ
rani	ㄹㅏㄴㅣ
hathaway	ㅎㅐㅅㅓㅇㅞㅇㅣ
dmitriy	ㄷㅡㅁㅣㅌㅡㄹㅣ
blackley	ㅂㅡㄹㄹㅐㅋㅡㄹㄹㅣ
carnie	ㅋㅏㄴㅣ
ullman	ㅇㅜㄹㅁㅓㄴ
valens	ㅂㅏㄹㄹㅔㄴㅅㅡ
bedingfield	ㅂㅔㄷㅣㅇㅍㅣㄹㄷㅡ
conroy	ㅋㅗㄴㄹㅗㅇㅣ
anastasiya	ㅇㅏㄴㅏㅅㅡㅌㅏㅅㅣㅇㅑ
montana	ㅁㅗㄴㅌㅐㄴㅏ
lesley	ㄹㅔㅅㅡㄹㄹㅣ
amago	ㅇㅏㅁㅏㄱㅗ
endel	ㅇㅔㄴㄷㅔㄹ
vico	ㅂㅣㅋㅗ
armas	ㅇㅏㄹㅡㅁㅏㅅㅡ
kahn	ㅋㅏㄴ
sanger	ㅅㅐㅇㅇㅓ
mowry	ㅁㅏㅇㅜㄹㅣ
jalal	ㅈㅏㄹㄹㅏㄹ
shaun	ㅅㅛㄴ
sana	ㅅㅏㄴㅏ
mcgraw	ㅁㅐㄱㄱㅡㄹㅗ
chiba	ㅅㅣㄱㅔㄹㅜ
nikola	ㄴㅣㅋㅗㄹㄹㅏ
carney	ㅋㅏㄴㅣ
mercedes	ㅁㅔㄹㅡㅅㅔㄷㅔㅅㅡ
marcus	ㅁㅏㄹㅡㅋㅜㅅㅡ
maria	ㅁㅏㄹㅣㅇㅏ
affleck	ㅇㅐㅍㅡㄹㄹㅔㄱ
penn	ㅍㅔㄴ
ladd	ㄹㅐㄷㅡ
krieger	ㅋㅡㄹㅣㄱㅓ
bernier	ㅂㅔㄹㅡㄴㅣㅇㅔ
best	ㅂㅔㅅㅡㅌㅡ
jansson	ㅇㅑㄴㅅㅗㄴ
zvonimir	ㅈㅡㅂㅗㄴㅣㅁㅣㄹㅡ
ronny	ㄹㅗㄴㅣ
sumner	ㅅㅓㅁㄴㅓ
hunter	ㅎㅓㄴㅌㅓ
kristen	ㅋㅡㄹㅣㅅㅡㅌㅣㄴ
estelle	ㅇㅔㅅㅡㅌㅔㄹ
toby	ㅌㅗㅂㅣ
hana	ㅎㅏㄴㅏ
ienobu	ㅇㅣㅇㅔㄴㅗㅂㅜ
kohl	ㅋㅗㄹ
shaheen	ㅅㅑㅎㅣㄴ
falco	ㅍㅏㄹㅋㅗ
nigel	ㄴㅏㅇㅣㅈㅓㄹ
escobar	ㅇㅔㅅㅡㅋㅗㅂㅏㄹㅡ
nicanor	ㄴㅣㅋㅏㄴㅗㄹㅡ
boris	ㅂㅗㄹㅣㅅㅡ
caan	ㅋㅏㄴ
junichi	ㅇㅘㅌㅏㄴㅏㅂㅔ
pitt	ㅍㅣㅌㅡ
larue	ㄹㅏㄹㅜ
dia	ㄷㅣㅇㅏ
madame	ㅍㅡㄹㅏㅇㅅㅡ
wladimir	ㅂㅡㄹㄹㅏㄷㅣㅁㅣㄹㅡ
sidney	ㅅㅣㄷㅡㄴㅣ
lombardo	ㄹㅗㅁㅂㅏㄷㅗ
channing	ㅊㅐㄴㅣㅇ
marling	ㅁㅏㄹㄹㅣㅇ
hasegawa	ㅈㅜㄴ
enzo	ㅇㅔㄴㅈㅗ
maurer	ㅁㅏㅇㅜㄹㅓ
shwe	ㅅㅠㅇㅞ
shingo	ㅁㅜㄹㅏㅋㅏㅁㅣ
tanya	ㅌㅐㄴㅣㅇㅏ
ashur	ㅇㅏㅅㅠㄹㅡ
levy	ㄹㅔㅂㅣ
garner	ㄱㅏㄴㅓ
read	ㄹㅣㄷㅡ
kabir	ㅋㅏㅂㅣㄹㅡ
hashimoto	ㅎㅣㄹㅗㅅㅣ
tarcisio	ㅌㅏㄹㅡㅊㅣㅅㅣㅇㅗ
flowers	ㅍㅡㄹㄹㅏㅇㅝㅅㅡ
gustav	ㄱㅜㅅㅡㅌㅏㅍㅡ
ante	ㅇㅏㄴㅌㅔ
zakharov	ㅈㅏㅎㅏㄹㅗㅍㅡ
sharbino	ㅅㅑㅂㅣㄴㅗ
ruy	ㄹㅜㅇㅣ
hopper	ㅎㅗㅍㅓ
moody	ㅁㅜㄷㅣ
byron	ㅂㅏㅇㅣㄹㅓㄴ
yoshishige	ㅇㅛㅅㅣㅅㅣㄱㅔ
susie	ㅅㅜㅈㅣ
juutilainen	ㅇㅠㅌㅣㄹㄹㅏㅇㅣㄴㅔㄴ
melo	ㅁㅔㄹㄹㅜ
eugen	ㅇㅗㅇㅣㄱㅔㄴ
nanni	ㄴㅏㄴㄴㅣ
azizi	ㅇㅏㅈㅣㅈㅣ
pires	ㅍㅣㄹㅔㅅㅡ
nikkanen	ㄴㅣㅋㅏㄴㅔㄴ
jung	ㅇㅠㅇ
potter	ㅍㅗㅌㅓ
damir	ㄷㅏㅁㅣㄹㅡ
sadler	ㅅㅐㄷㅡㄹㄹㅓ
sonia	ㅅㅗㄴㅣㅇㅏ
thunberg	ㅌㅜㄴㅂㅔㄹㅣ
born	ㅂㅗㄹㅡㄴ
ryota	ㅇㅏㅇㅗㅋㅣ
boy	ㅂㅗㅇㅣ
yeoman	ㅇㅛㅁㅓㄴ
story	ㅅㅡㅌㅗㄹㅣ
daniel	ㄷㅐㄴㅣㅇㅓㄹ
erhard	ㅇㅔㄹㅡㅎㅏㄹㅡㅌㅡ
andrey	ㅇㅏㄴㄷㅡㄹㅔㅇㅣ
bree	ㅂㅡㄹㅣ
merkel	ㅁㅔㄹㅡㅋㅔㄹ
vagiz	ㅂㅏㄱㅣㅈㅡ
lang	ㄹㅐㅇ
howe	ㅎㅏㅇㅜ
ines	ㅇㅣㄴㅔㅅㅡ
mihai	ㅁㅣㅎㅏㅇㅣ
cherry	ㅊㅔㄹㅣ
tanui	ㅌㅏㄴㅜㅇㅣ
nagamasa	ㄴㅏㄱㅏㅁㅏㅅㅏ
india	ㅇㅣㄴㄷㅣㅇㅏ
miura	ㅁㅣㅇㅜㄹㅏ
jam	ㅈㅐㅁ
ilaria	ㅇㅣㄹㄹㅏㄹㅣㅇㅏ
donato	ㄷㅗㄴㅏㅌㅗ
mcdaniel	ㅁㅐㄱㄷㅐㄴㅣㅇㅓㄹ
angie	ㅇㅐㄴㅈㅣ
arturo	ㅇㅏㄹㅡㅌㅜㄹㅗ
jayavarman	ㅈㅏㅇㅑㅂㅏㄹㅡㅁㅏㄴ
earl	ㅇㅓㄹ
handler	ㅎㅐㄴㄷㅡㄹㄹㅓ
ryder	ㄹㅏㅇㅣㄷㅓ
dino	ㄷㅣㄴㅗ
kent	ㅋㅔㄴㅌㅡ
allan	ㅇㅐㄹㄹㅓㄴ
araya	ㅇㅏㄹㅏㅇㅑ
dutta	ㄷㅜㅌㅏ
pedersen	ㅍㅔㄷㅔㄹㅡㅅㅔㄴ
marvin	ㅁㅏㅂㅣㄴ
cabrera	ㅋㅏㅂㅡㄹㅔㄹㅏ
samson	ㅅㅐㅁㅅㅡㄴ
bandaranaike	ㅂㅏㄴㄷㅏㄹㅏㄴㅏㅇㅣㅋㅔ
gama	ㄱㅏㅁㅏ
roman	ㄹㅗㅁㅏㄴ
canto	ㅋㅏㄴㅌㅗ
tecumseh	ㅌㅔㅋㅜㅁㅅㅔ
justyna	ㅇㅠㅅㅡㅌㅣㄴㅏ
valerie	ㅂㅐㄹㄹㅓㄹㅣ
erika	ㅇㅔㄹㅣㅋㅏ
danuta	ㄷㅏㄴㅜㅌㅏ
neri	ㄴㅔㄹㅣ
nemec	ㄴㅔㅁㅔㄱ
olesya	ㅇㅗㄹㄹㅔㅅㅑ
maximilien	ㅁㅏㄱㅅㅣㅁㅣㄹㄹㅣㅇㅏㅇ
roddy	ㄹㅗㄷㅣ
brunet	ㅂㅡㄹㅟㄴㅔ
pompeo	ㅍㅗㅁㅍㅔㅇㅗ
garnier	ㄱㅏㄹㅡㄴㅣㅇㅔ
carrero	ㅋㅏㄹㅔㄹㅗ
aiken	ㅇㅔㅇㅣㅋㅣㄴ
wim	ㅂㅣㅁ
jolene	ㅈㅗㄹㄹㅣㄴ
luna	ㄹㅜㄴㅏ
engels	ㅇㅔㅇㄱㅔㄹㅅㅡ
halsey	ㅎㅗㄹㅅㅣ
bronfenbrenner	ㅂㅡㄹㅗㄴㅍㅔㄴㅂㅡㄹㅔㄴㅓ
luis	ㄹㅜㅇㅣㅅㅡ
abboud	ㅇㅏㅂㅜㄷㅡ
rubin	ㄹㅜㅂㅣㄴ
lindblom	ㄹㅣㄴㄷㅡㅂㅡㄹㄹㅗㅁ
rollins	ㄹㅗㄹㄹㅣㄴㅅㅡ
hiroyuki	ㄱㅗㅂㅏㅇㅑㅅㅣ
syers	ㅅㅏㅇㅣㅇㅓㅅㅡ
taylor	ㅌㅔㅇㅣㄹㄹㅓ
milan	ㅁㅣㄹㄹㅏㄴ
lovelace	ㄹㅓㅂㅡㄹㅔㅇㅣㅅㅡ
tristan	ㅌㅡㄹㅣㅅㅡㅌㅏㄴ
barker	ㅂㅏㅋㅓ
mizuno	ㅁㅣㅈㅡㄴㅗ
mir	ㅁㅣㄹㅡ
hemsworth	ㅎㅔㅁㅅㅡㅇㅝㅅㅡ
dicaprio	ㄷㅣㅋㅏㅍㅡㄹㅣㅇㅗ
peake	ㅍㅣㅋㅡ
lucena	ㄹㅜㅅㅔㄴㅏ
fujimori	ㅎㅜㅈㅣㅁㅗㄹㅣ
jake	ㅈㅔㅇㅣㅋㅡ
claudius	ㅋㅡㄹㄹㅏㅇㅜㄷㅣㅇㅜㅅㅡ
hjalmar	ㅎㅑㄹㅁㅏㄹㅡ
vidal	ㅂㅣㄷㅏㄹ
oriol	ㅇㅗㄹㅣㅇㅗㄹ
ivanova	ㅇㅣㅂㅏㄴㅗㅂㅏ
yoshiko	ㅇㅛㅅㅣㅋㅗ
kelvin	ㅋㅔㄹㅂㅣㄴ
costas	ㅋㅗㅅㅡㅌㅏㅅㅡ
juha	ㅇㅠㅎㅏ
hermann	ㅎㅔㄹㅡㅁㅏㄴ
rankin	ㄹㅐㅇㅋㅣㄴ
villa	ㅂㅣㅇㅑ
rodion	ㄹㅗㄷㅣㅇㅗㄴ
ten	ㅌㅔㄴ
indira	ㅇㅣㄴㄷㅣㄹㅏ
belisario	ㅂㅔㄹㄹㅣㅅㅏㄹㅣㅇㅗ
nina	ㄴㅣㄴㅏ
payton	ㅍㅔㅇㅣㅌㅓㄴ
maureen	ㅁㅗㄹㅣㄴ
sara	ㅅㅏㄹㅏ
ashton	ㅇㅐㅅㅠㅌㅓㄴ
zhuk	ㅈㅜㅋㅡ
hermannsson	ㅎㅔㄹㅡㅁㅏㄴㅅㅗㄴ
casella	ㅋㅏㅅㅔㄹㄹㅏ
toyotomi	ㄷㅗㅇㅛㅌㅗㅁㅣ
kennedy	ㅋㅔㄴㅔㄷㅣ
artur	ㅇㅏㄹㅡㅌㅜㄹㅡ
aries	ㅇㅔㄹㅣㅅㅡ
grant	ㄱㅡㄹㅐㄴㅌㅡ
chu	ㅊㅜ
pink	ㅍㅣㅇㅋㅡ
henryk	ㅎㅔㄴㄹㅣㅋㅡ
santana	ㅅㅏㄴㅌㅏㄴㅏ
kurt	ㅋㅜㄹㅡㅌㅡ
good	ㄱㅜㅅ
shima	ㅅㅣㅁㅏ
hatch	ㅎㅐㅊㅣ
alexey	ㅇㅏㄹㄹㅔㄱㅅㅔㅇㅣ
darko	ㄷㅏㄹㅡㅋㅗ
emanuele	ㅇㅔㅁㅏㄴㅜㅇㅔㄹㄹㅔ
aristide	ㅇㅏㄹㅣㅅㅡㅌㅣㄷㅡ
fuchs	ㅍㅜㄱㅅㅡ
luc	ㄹㅟㄱ
dickson	ㄷㅣㄱㅅㅡㄴ
phillip	ㅍㅣㄹㄹㅣㅂ
boole	ㅂㅜㄹ
joaquim	ㅈㅗㅇㅏㅋㅣㅇ
morrison	ㅁㅗㄹㅣㅅㅡㄴ
mcdowell	ㅁㅐㄱㄷㅗㅇㅞㄹ
mintz	ㅁㅣㄴㅊㅡ
franklin	ㅍㅡㄹㅐㅇㅋㅡㄹㄹㅣㄴ
raffaele	ㄹㅏㅍㅏㅇㅔㄹㄹㅔ
bram	ㅂㅡㄹㅐㅁ
frick	ㅍㅡㄹㅣㅋㅡ
doyle	ㄷㅗㅇㅣㄹ
audrey	ㅇㅗㄷㅡㄹㅣ
james	ㅈㅔㅇㅣㅁㅅㅡ
schelling	ㅅㅖㄹㄹㅣㅇ
stiller	ㅅㅡㅌㅣㄹㄹㅓ
nobutada	ㄴㅗㅂㅜㅌㅏㄷㅏ
giles	ㅈㅏㅇㅣㄹㅅㅡ
chuck	ㅊㅓㄱ
zappa	ㅈㅏㅍㅏ
fischer	ㅍㅣㅅㅕ
kalou	ㅋㅏㄹㄹㅜ
emiliano	ㅇㅔㅁㅣㄹㄹㅣㅇㅏㄴㅗ
sybil	ㅅㅣㅂㅣㄹ
juliette	ㅈㅟㄹㄹㅣㅇㅔㅌㅡ
oleh	ㅇㅗㄹㄹㅔㅎㅡ
ayala	ㅇㅏㅇㅑㄹㄹㅏ
gomez	ㄱㅗㅁㅔㅈㅡ
godfrey	ㄱㅗㄷㅡㅍㅡㄹㅣ
g	ㅈㅣ
forsyth	ㅍㅗㅅㅏㅇㅣㅅㅡ
nakagawa	ㄴㅏㅋㅏㄱㅏㅇㅘ
kanai	ㅁㅣㅋㅣ
cocker	ㅋㅗㅋㅓ
gert	ㄱㅔㄹㅡㅌㅡ
arkin	ㅇㅏㅋㅣㄴ
gaudino	ㄱㅏㅇㅜㄷㅣㄴㅗ
soter	ㅅㅗㅌㅔㄹㅡ
nagao	ㄴㅏㄱㅏㅇㅗ
ryne	ㄹㅏㅇㅣㄴ
thomsen	ㅌㅗㅁㅅㅔㄴ
america	ㅇㅏㅁㅔㄹㅣㅋㅏ
will	ㅇㅟㄹ
kirill	ㅋㅣㄹㅣㄹ
barnett	ㅂㅏㄴㅔㅅ
antiochus	ㅇㅏㄴㅌㅣㅇㅗㅋㅗㅅㅡ
hewson	ㅎㅠㅅㅡㄴ
hammond	ㅎㅐㅁㅓㄴㄷㅡ
nakashima	ㅇㅠㅋㅣ
bel	ㅂㅔㄹ
toshio	ㅇㅘㅌㅏㄴㅏㅂㅔ
nagakatsu	ㄴㅏㄱㅏㅋㅏㅆㅡ
melville	ㅁㅔㄹㅂㅣㄹ
yang	ㅇㅑㅇ
montero	ㅁㅗㄴㅌㅔㄹㅗ
lesli	ㄹㅔㅅㅡㄹㄹㅣ
birch	ㅂㅓㅊㅣ
chlothar	ㅋㅡㄹㄹㅗㅌㅏㄹㅡ
matthews	ㅁㅐㅅㅠㅅㅡ
sullivan	ㅅㅓㄹㄹㅣㅂㅓㄴ
may	ㅁㅔㅇㅣ
aono	ㄷㅏㅋㅔㅅㅣ
clemens	ㅋㅡㄹㄹㅔㅁㅔㄴㅅㅡ
villani	ㅂㅣㄹㄹㅏㄴㅣ
jeffery	ㅈㅔㅍㅡㄹㅣ
narayanan	ㄴㅏㄹㅏㅇㅑㄴㅏㄴ
elsa	ㅇㅔㄹㅅㅏ
deniz	ㄷㅔㄴㅣㅈㅡ
houston	ㅎㅠㅅㅡㅌㅓㄴ
ecaterina	ㅇㅔㅋㅏㅌㅔㄹㅣㄴㅏ
rea	ㄹㅔㅇㅏ
andrew	ㅇㅐㄴㄷㅡㄹㅜ
verner	ㅂㅔㄹㅡㄴㅓ
paulo	ㅍㅏㅇㅜㄹㄹㅜ
junior	ㅈㅜㄴㅣㅇㅗㄹㅡ
petra	ㅍㅔㅌㅡㄹㅏ
harrington	ㅎㅐㄹㅣㅇㅌㅓㄴ
yuri	ㅇㅠㄹㅣ
desi	ㄷㅔㅅㅣ
power	ㅍㅏㅇㅝ
marco	ㅁㅏㄹㅡㅋㅗ
lagos	ㄹㅏㄱㅗㅅㅡ
laurence	ㄹㅗㄹㅓㄴㅅㅡ
bragg	ㅂㅡㄹㅐㄱㅡ
janssen	ㅇㅑㄴㅅㅔㄴ
grigory	ㄱㅡㄹㅣㄱㅗㄹㅣ
miyake	ㅁㅣㅇㅑㅋㅔ
kravitz	ㅋㅡㄹㅏㅂㅣㅊㅡ
jerzy	ㅇㅖㅈㅣ
ferrari	ㅍㅔㄹㅏㄹㅣ
oswaldo	ㅇㅗㅅㅡㅇㅘㄹㄷㅗ
masanobu	ㅁㅏㅅㅏㄴㅗㅂㅜ
feuerbach	ㅍㅗㅇㅣㅇㅓㅂㅏㅎㅡ
zlatko	ㅈㅡㄹㄹㅏㅌㅡㅋㅗ
anu	ㅇㅏㄴㅜ
massey	ㅁㅐㅅㅣ
farrar	ㅍㅏㄹㅏ
andrea	ㅇㅏㄴㄷㅡㄹㅔㅇㅏ
jarvis	ㅈㅏㅂㅣㅅㅡ
tao	ㅌㅏㅇㅗ
fast	ㅍㅐㅅㅡㅌㅡ
mindy	ㅁㅣㄴㄷㅣ
elaine	ㅇㅣㄹㄹㅔㅇㅣㄴ
udall	ㅇㅠㄷㅗㄹ
berisha	ㅂㅔㄹㅣㅅㅑ
hinds	ㅎㅏㅇㅣㄴㅈㅡ
aisha	ㅇㅏㅇㅣㅅㅑ
nicol	ㄴㅣㅋㅗㄹ
mahmoud	ㅁㅏㅎㅡㅁㅜㄷㅡ
alberto	ㅇㅏㄹㅂㅔㄹㅡㅌㅗ
albornoz	ㅇㅏㄹㅂㅗㄹㅡㄴㅗㅅㅡ
kendall	ㅋㅔㄴㄷㅡㄹ
dennis	ㄷㅔㄴㅣㅅㅡ
adelina	ㅇㅏㄷㅔㄹㄹㅣㄴㅏ
alonso	ㅇㅏㄹㄹㅗㄴㅅㅗ
manuela	ㅁㅏㄴㅜㅇㅔㄹㄹㅏ
sting	ㅅㅡㅌㅣㅇ
yuliya	ㅇㅠㄹㄹㅣㅇㅑ
rio	ㄹㅣㅇㅗ
jaffrey	ㅈㅐㅍㅡㄹㅣ
jorja	ㅈㅗㅈㅏ
daniela	ㄷㅏㄴㅣㅇㅔㄹㄹㅏ
soto	ㅅㅗㅌㅗ
gilberto	ㅈㅣㅇㅜㅂㅔㄹㅡㅌㅜ
imran	ㅇㅣㅁㄹㅏㄴ
renata	ㄹㅔㄴㅏㅌㅏ
kimiko	ㅋㅣㅁㅣㅋㅗ
steiner	ㅅㅠㅌㅏㅇㅣㄴㅓ
jeff	ㅈㅔㅍㅡ
antar	ㅇㅏㄴㅌㅏㄹㅡ
gonzalez	ㄱㅗㄴㅅㅏㄹㄹㅔㅅㅡ
andersson	ㅇㅏㄴㄷㅔㄹㅡㅅㅗㄴ
erick	ㅇㅔㄹㅣㄱ
takatsukasa	ㄷㅏㅋㅏㅆㅡㅋㅏㅅㅏ
duff	ㄷㅓㅍㅡ
brooks	ㅂㅡㄹㅜㄱㅅㅡ
torp	ㅌㅗㄹㅡㅍㅡ
gwen	ㄱㅡㅇㅞㄴ
rex	ㄹㅔㄱㅅㅡ
renoir	ㄹㅡㄴㅜㅇㅏㄹㅡ
valette	ㅂㅏㄹㄹㅔㅌㅡ
rusa	ㄹㅜㅅㅏㅅㅡ
sunil	ㅅㅜㄴㅣㄹ
ignacio	ㅇㅣㄱㅡㄴㅏㅅㅣㅇㅗ
tamsin	ㅌㅐㅁㅅㅣㄴ
neto	ㄴㅔㅌㅜ
shirley	ㅅㅕㄹㄹㅣ
versace	ㅂㅔㄹㅡㅅㅏㅊㅔ
jessy	ㅈㅔㅅㅣ
satomi	ㅅㅡㅈㅡㅋㅣ
obiang	ㅇㅗㅂㅣㅇㅏㅇ
alexa	ㅇㅏㄹㄹㅔㄱㅅㅏ
yilmaz	ㅇㅣㄹㅁㅏㅈㅡ
nasrin	ㄴㅏㅅㅡㄹㅣㄴ
ute	ㅇㅜㅌㅔ
forsythe	ㅍㅗㅅㅏㅇㅣㅅㅡ
vince	ㅂㅣㄴㅅㅡ
salinas	ㅅㅏㄹㄹㅣㄴㅏㅅㅡ
sebastian	ㅈㅔㅂㅏㅅㅡㅌㅣㅇㅏㄴ
lyubov	ㄹㅠㅂㅗㅍㅡ
kiprotich	ㅋㅣㅍㅡㄹㅗㅌㅣㅊㅣ
theuderic	ㅌㅔㅇㅜㄷㅔㄹㅣㅎㅣ
macfadyen	ㅁㅐㄱㅍㅔㅇㅣㄷㅡㄴ
anitta	ㅇㅏㄴㅣㅌㅏ
michal	ㅁㅣㅎㅏㄹ
cassavetes	ㅋㅏㅅㅏㅂㅔㅌㅣㅅㅡ
drest	ㄷㅡㄹㅔㅅㅡㅌㅡ
leona	ㄹㅣㅇㅗㄴㅏ
aoki	ㅅㅏㅇㅑㅋㅏ
nobuharu	ㄴㅗㅂㅜㅎㅏㄹㅜ
nene	ㄴㅔㄴㅔ
archer	ㅇㅏㅊㅓ
ella	ㅇㅔㄹㄹㅏ
morley	ㅁㅗㄹㄹㅣ
ariel	ㅇㅏㄹㅣㅇㅔㄹ
grethe	ㄱㅡㄹㅔㅌㅔ
busquets	ㅂㅜㅅㅡㅋㅔㅊㅡ
treadaway	ㅌㅡㄹㅔㄷㅓㅇㅞㅇㅣ
youssouf	ㅇㅠㅅㅜㅍㅡ
morgan	ㅁㅗㄱㅓㄴ
bunn	ㅂㅓㄴ
radu	ㄹㅏㄷㅜ
ackermann	ㅇㅏㅋㅓㅁㅏㄴ
kobayakawa	ㄱㅗㅂㅏㅇㅑㅋㅏㅇㅘ
jimmie	ㅈㅣㅁㅣ
bingham	ㅂㅣㅇㅇㅓㅁ
maia	ㅁㅏㅇㅣㅇㅏ
yoshikatsu	ㅇㅛㅅㅣㅋㅏㅆㅡ
rohl	ㄹㅗㄹ
palladino	ㅍㅏㄹㄹㅏㄷㅣㄴㅗ
naohiro	ㄴㅏㅇㅗㅎㅣㄹㅗ
viola	ㅂㅣㅇㅗㄹㄹㅏ
alyssa	ㅇㅐㄹㄹㅣㅅㅏ
holm	ㅎㅗㅁ
irving	ㅇㅓㅂㅣㅇ
ingi	ㅇㅣㅇㄱㅣ
cody	ㅋㅗㄷㅣ
leland	ㄹㅣㄹㄹㅓㄴㄷㅡ
smart	ㅅㅡㅁㅏㅌㅡ
elio	ㅇㅔㄹㄹㅣㅇㅗ
halina	ㅎㅏㄹㄹㅣㄴㅏ
kacey	ㅋㅔㅇㅣㅅㅣ
green	ㄱㅡㄹㅣㄴ
pascual	ㅍㅏㅅㅡㅋㅜㅇㅏㄹ
langley	ㄹㅐㅇㄱㅡㄹㄹㅣ
sylvain	ㅅㅣㄹㅂㅐㅇ
parr	ㅍㅏ
andris	ㅇㅏㄴㄷㅡㄹㅣㅅㅡ
ippolito	ㅇㅣㅍㅗㄹㄹㅣㅌㅗ
edwards	ㅇㅔㄷㅡㅇㅝㅈㅡ
hervey	ㅎㅓㅂㅣ
martinez	ㅁㅏㄹㅡㅌㅣㄴㅔㅅㅡ
russell	ㄹㅓㅅㅔㄹ
niwa	ㄴㅣㅇㅘ
pellegrino	ㅍㅔㄹㄹㅔㄱㅡㄹㅣㄴㅗ
amber	ㅇㅐㅁㅂㅓ
gillen	ㄱㅣㄹㄹㅓㄴ
viktors	ㅂㅣㄱㅌㅗㄹㅡㅅㅡ
molina	ㅁㅗㄹㄹㅣㄴㅏ
solbakken	ㅅㅗㄹㅂㅏㅋㅔㄴ
shepherd	ㅅㅖㅍㅓㄷㅡ
mahamadou	ㅁㅏㅎㅏㅁㅏㄷㅜ
lan	ㄹㅏㄴ
karamanlis	ㅋㅏㄹㅏㅁㅏㄴㄹㅣㅅㅡ
somyot	ㅅㅗㅁㅇㅛㅅ
gabriele	ㄱㅏㅂㅡㄹㅣㅇㅔㄹㄹㅔ
stef	ㅅㅡㅌㅔㅍㅡ
vittorio	ㅂㅣㅌㅗㄹㅣㅇㅗ
amedeo	ㅇㅏㅁㅔㄷㅔㅇㅗ
elizabeth	ㅇㅔㄹㄹㅣㅈㅏㅂㅔㅅㅡ
aurel	ㅇㅏㅇㅜㄹㅔㄹ
iva	ㅇㅣㅂㅏ
luque	ㄹㅜㅋㅔ
huss	ㅎㅓㅅㅡ
khama	ㅋㅏㅁㅏ
cho	ㅈㅗ
giuliana	ㅈㅜㄹㄹㅣㅇㅏㄴㅏ
for	ㅍㅗ
foss	ㅍㅗㅅㅡ
scarlatti	ㅅㅡㅋㅏㄹㅡㄹㄹㅏㅌㅣ
isabel	ㅇㅣㅅㅏㅂㅔㄹ
curt	ㅋㅓㅌㅡ
zozulya	ㅈㅗㅈㅜㄹㄹㅑ
cornell	ㅋㅗㄴㅔㄹ
foucault	ㅍㅜㅋㅗ
francesco	ㅍㅡㄹㅏㄴㅊㅔㅅㅡㅋㅗ
lajoie	ㄹㅏㅈㅗㅇㅣ
rockefeller	ㄹㅗㄱㅍㅔㄹㄹㅓ
jackie	ㅈㅐㅋㅣ
yordan	ㅇㅛㄹㅡㄷㅏㄴ
yancy	ㅇㅑㄴㅅㅣ
paget	ㅍㅐㅈㅣㅅ
silvestre	ㅅㅣㄹㅂㅔㅅㅡㅌㅡㄹㅡ
evan	ㅇㅔㅂㅓㄴ
redknapp	ㄹㅔㄷㅡㄴㅐㅂ
menezes	ㅁㅔㄴㅔㅈㅔㅅㅡ
matsunaga	ㅁㅏㅆㅡㄴㅏㄱㅏ
suvorov	ㅅㅜㅂㅗㄹㅗㅍㅡ
bodo	ㅂㅗㄷㅗ
gerd	ㄱㅔㄹㅡㅌㅡ
short	ㅅㅛㅌㅡ
bradshaw	ㅂㅡㄹㅐㄷㅡㅅㅛ
fyodor	ㅍㅛㄷㅗㄹㅡ
jacopo	ㅇㅑㅋㅗㅍㅗ
waterston	ㅇㅝㅌㅓㅅㅡㅌㅓㄴ
yoshizumi	ㅇㅛㅅㅣㅈㅡㅁㅣ
sally	ㅅㅐㄹㄹㅣ
einaudi	ㅇㅔㅇㅣㄴㅏㅇㅜㄷㅣ
saki	ㄴㅏㅋㅏㅈㅣㅁㅏ
milanov	ㅁㅣㄹㄹㅏㄴㅗㅍㅡ
tanuma	ㄷㅏㄴㅜㅁㅏ
kavadh	ㅋㅏㅂㅏㄷㅡ
como	ㅋㅗㅁㅗ
tiger	ㅌㅏㅇㅣㄱㅓ
augustus	ㅇㅏㅇㅜㄱㅜㅅㅡㅌㅜㅅㅡ
piccoli	ㅍㅣㅋㅗㄹㄹㅣ
sarduri	ㅅㅏㄹㅡㄷㅜㄹㅣ
agnew	ㅇㅐㄱㅡㄴㅠ
draper	ㄷㅡㄹㅐㅍㅓ
bushnell	ㅂㅜㅅㅠㄴㅓㄹ
daniella	ㄷㅏㄴㅣㅇㅔㄹㄹㅏ
masatsugu	ㅁㅏㅅㅏㅆㅡㄱㅜ
susannah	ㅅㅜㅈㅐㄴㅏ
bambang	ㅂㅏㅁㅂㅏㅇ
veronica	ㅂㅔㄹㅗㄴㅣㅋㅏ
hemings	ㅎㅔㅁㅣㅇㅅㅡ
kazimierz	ㅋㅏㅈㅣㅁㅣㅇㅔㅅㅣ
pavol	ㅍㅏㅂㅗㄹ
rolandas	ㄹㅗㄹㄹㅏㄴㄷㅏㅅㅡ
medvedeva	ㅁㅔㄷㅡㅂㅔㄷㅔㅂㅏ
denis	ㄷㅔㄴㅣㅅㅡ
diawara	ㄷㅣㅇㅏㅇㅘㄹㅏ
pogba	ㅍㅗㄱㅡㅂㅏ
mamet	ㅁㅐㅁㅣㅅ
oyelowo	ㅇㅗㅇㅖㄹㄹㅓㅇㅝ
narayan	ㄴㅏㄹㅏㅇㅑㄴ
meera	ㅁㅣㄹㅏ
abdulla	ㅇㅏㅂㄷㅜㄹㄹㅏ
isaac	ㅇㅏㅇㅣㅈㅏㄱ
nieto	ㄴㅣㅇㅔㅌㅗ
goldwyn	ㄱㅗㄹㄷㅡㅇㅟㄴ
hoekstra	ㅎㅜㄱㅅㅡㅌㅡㄹㅏ
portnoy	ㅍㅗㅌㅡㄴㅗㅇㅣ
kristin	ㅋㅡㄹㅣㅅㅡㅌㅣㄴ
gandy	ㄱㅐㄴㄷㅣ
scotland	ㅋㅗㄹㄹㅜㅁ
arif	ㅇㅏㄹㅣㅍㅡ
orff	ㅇㅗㄹㅡㅍㅡ
aumann	ㅇㅏㅇㅜㅁㅏㄴ
naokatsu	ㄴㅏㅇㅗㅋㅏㅆㅡ
trick	ㅌㅡㄹㅣㄱ
shore	ㅅㅛㅇㅓ
paddy	ㅍㅐㄷㅣ
strong	ㅅㅡㅌㅡㄹㅗㅇ
silva	ㅅㅣㅇㅜㅂㅏ
hamann	ㅎㅏㅁㅏㄴ
reinhold	ㄹㅏㅇㅣㄴㅎㅗㄹㅌㅡ
christensen	ㅋㅡㄹㅣㅅㅡㅌㅔㄴㅅㅔㄴ
licia	ㄹㅣㅊㅏ
dinu	ㄷㅣㄴㅜ
dance	ㄷㅐㄴㅅㅡ
janel	ㅈㅐㄴㅓㄹ
lucien	ㄹㅟㅅㅣㅇㅐㅇ
hare	ㅎㅔㅇㅓ
manu	ㅁㅏㄴㅜ
pollak	ㅍㅗㄹㄹㅏㄱ
salinger	ㅅㅐㄹㄹㅣㄴㅈㅓ
yates	ㅇㅖㅇㅣㅊㅡ
joel	ㅈㅗㅇㅔㄹ
asad	ㅇㅏㅅㅏㄷㅡ
kazuya	ㅁㅏㅇㅔㄷㅏ
bea	ㅂㅔㅇㅏ
tadashige	ㄷㅏㄷㅏㅅㅣㄱㅔ
poli	ㅍㅗㄹㄹㅣ
catherine	ㅋㅐㅅㅓㄹㅣㄴ
solossa	ㅅㅗㄹㄹㅗㅅㅏ
udo	ㅇㅜㄷㅗ
joshi	ㅈㅗㅅㅣ
hines	ㅎㅏㅇㅣㄴㅅㅡ
rickey	ㄹㅣㅋㅣ
soni	ㅅㅗㄴㅣ
desai	ㄷㅔㅅㅏㅇㅣ
zakaria	ㅈㅏㅋㅏㄹㅣㅇㅏ
kenyatta	ㅋㅔㄴㅑㅌㅏ
mccoy	ㅁㅐㅋㅗㅇㅣ
shayne	ㅅㅖㅇㅣㄴ
presley	ㅍㅡㄹㅔㅅㅡㄹㄹㅣ
keaton	ㅋㅣㅌㅡㄴ
pickering	ㅍㅣㅋㅓㄹㅣㅇ
maya	ㅁㅏㅇㅑ
kajsa	ㅋㅏㅇㅣㅅㅏ
bartolomeo	ㅂㅏㄹㅡㅌㅗㄹㄹㅗㅁㅔㅇㅗ
lane	ㄹㅔㅇㅣㄴ
polanyi	ㅍㅗㄹㄹㅏㄴㅣ
valeri	ㅂㅏㄹㄹㅔㄹㅣ
hoang	ㅎㅗㅇㅏㅇ
lexa	ㄹㅔㄱㅅㅏ
holden	ㅎㅗㄹㄷㅡㄴ
nightingale	ㄴㅏㅇㅣㅌㅣㅇㄱㅔㅇㅣㄹ
ashleigh	ㅇㅐㅅㅠㄹㄹㅣ
wilmer	ㅇㅟㄹㅁㅓ
boutayeb	ㅂㅜㅌㅏㅇㅖㅂㅡ
tyree	ㅌㅏㅇㅣㄹㅣ
ana	ㅇㅏㄴㅏ
cara	ㅋㅏㄹㅏ
ortega	ㅇㅗㄹㅡㅌㅔㄱㅏ
perea	ㅍㅔㄹㅔㅇㅏ
fares	ㅍㅏㄹㅔㅅㅡ
barrie	ㅂㅐㄹㅣ
hawthorne	ㅎㅗㅅㅗㄴ
shriver	ㅅㅠㄹㅏㅇㅣㅂㅓ
mostow	ㅁㅗㅅㅡㅌㅗ
bryson	ㅂㅡㄹㅏㅇㅣㅅㅡㄴ
miriam	ㅁㅣㄹㅣㅇㅓㅁ
brewster	ㅂㅡㄹㅜㅅㅡㅌㅓ
tovey	ㅌㅗㅂㅣ
ashanti	ㅇㅏㅅㅑㄴㅌㅣ
somerville	ㅅㅓㅁㅓㅂㅣㄹ
paulista	ㅍㅏㅇㅜㄹㄹㅣㅅㅡㅌㅏ
bernard	ㅂㅓㄴㅏㄷㅡ
abbas	ㅇㅏㅂㅏㅅㅡ
johnstone	ㅈㅗㄴㅅㅡㅌㅗㄴ
anselm	ㅇㅏㄴㅈㅔㄹㄹㅡㅁ
halim	ㅎㅏㄹㄹㅣㅁ
maude	ㅁㅗㄷㅡ
woody	ㅇㅜㄷㅣ
jorginho	ㅈㅗㄹㅡㅈㅣㄴㅠ
sophus	ㅅㅗㅍㅜㅅㅡ
nagashige	ㄴㅏㄱㅏㅅㅣㄱㅔ
stirling	ㅅㅡㅌㅓㄹㄹㅣㅇ
ridgway	ㄹㅣㅈㅣㅇㅞㅇㅣ
webber	ㅇㅞㅂㅓ
efstathios	ㅇㅔㅍㅡㅅㅡㅌㅏㅌㅣㅇㅗㅅㅡ
mumford	ㅁㅓㅁㅍㅓㄷㅡ
laird	ㄹㅔㅇㅓㄷㅡ
sands	ㅅㅐㄴㅈㅡ
ambrosini	ㅇㅏㅁㅂㅡㄹㅗㅅㅣㄴㅣ
mendes	ㅁㅔㄴㄷㅔㅅㅡ
nelly	ㄴㅔㄹㄹㅣ
obrian	ㅇㅗㅂㅡㄹㅏㅇㅣㅇㅓㄴ
larsson	ㄹㅏㄹㅡㅅㅗㄴ
otis	ㅇㅗㅌㅣㅅㅡ
neha	ㄴㅔㅎㅏ
eamon	ㅇㅔㅇㅣㅁㅓㄴ
burr	ㅂㅓ
daouda	ㄷㅏㅇㅜㄷㅏ
donny	ㄷㅗㄴㅣ
kulik	ㅋㅜㄹㄹㅣㅋㅡ
kawakami	ㅋㅏㅇㅘㅋㅏㅁㅣ
christie	ㅋㅡㄹㅣㅅㅡㅌㅣ
hilton	ㅎㅣㄹㅌㅓㄴ
numan	ㄴㅜㅁㅏㄴ
morse	ㅁㅗㅅㅡ
placido	ㅍㅡㄹㄹㅏㅊㅣㄷㅗ
frederik	ㅍㅡㄹㅔㄷㅔㄹㅣㅋㅡ
dunne	ㄷㅓㄴ
renate	ㄹㅔㄴㅏㅌㅔ
buscema	ㅂㅜㅅㅖㅁㅏ
tolstoy	ㅌㅗㄹㅅㅡㅌㅗㅇㅣ
horace	ㅎㅗㄹㅓㅅㅡ
katsunaga	ㄱㅏㅆㅡㄴㅏㄱㅏ
siyabonga	ㅅㅣㅇㅑㅂㅗㅇㄱㅏ
robbie	ㄹㅗㅂㅣ
pineda	ㅍㅣㄴㅔㄷㅏ
dirk	ㄷㅣㄹㅡㅋㅡ
schulze	ㅅㅠㄹㅈㅡ
ane	ㅇㅏㄴㅔ
jonatas	ㅈㅗㄴㅏㅌㅏㅅㅡ
margrethe	ㅁㅏㄹㅡㄱㅡㄹㅔㅌㅔ
ambrose	ㅇㅐㅁㅂㅡㄹㅗㅈㅡ
bedi	ㅂㅔㄷㅣ
martinelli	ㅁㅏㄹㅡㅌㅣㄴㅔㄹㄹㅣ
irvine	ㅇㅓㅂㅣㄴ
katelyn	ㅋㅔㅇㅣㅌㅡㄹㄹㅣㄴ
sadayoshi	ㅅㅏㄷㅏㅇㅛㅅㅣ
abdullahi	ㅇㅏㅂㄷㅜㄹㄹㅏㅎㅣ
abreu	ㅇㅏㅂㅡㄹㅔㅇㅜ
yoshinari	ㅇㅛㅅㅣㄴㅏㄹㅣ
schmidt	ㅅㅠㅁㅣㅌㅡ
charibert	ㅎㅏㄹㅣㅂㅔㄹㅡㅌㅡ
uesugi	ㅇㅜㅇㅔㅅㅡㄱㅣ
petter	ㅍㅔㅌㅔㄹㅡ
polanski	ㅍㅗㄹㄹㅏㄴㅅㅡㅋㅣ
cristian	ㅋㅡㄹㅣㅅㅡㅌㅣㅇㅏㄴ
hecker	ㅎㅔㅋㅓ
ukita	ㅇㅜㅋㅣㅌㅏ
asa	ㅇㅏㅅㅏ
niklas	ㄴㅣㅋㅡㄹㄹㅏㅅㅡ
ayumi	ㅇㅣㅅㅣㄷㅏ
klitschko	ㅋㅡㄹㄹㅣㅊㅣㅋㅗ
reeves	ㄹㅣㅂㅡㅅㅡ
carsten	ㅋㅏㄹㅡㅅㅡㅌㅔㄴ
manolas	ㅁㅏㄴㅗㄹㄹㅏㅅㅡ
teemu	ㅌㅔㅁㅜ
skinner	ㅅㅡㅋㅣㄴㅓ
immonen	ㅇㅣㅁㅓㄴㅓㄴ
antonis	ㅇㅏㄴㅌㅗㄴㅣㅅㅡ
clyde	ㅋㅡㄹㄹㅏㅇㅣㄷㅡ
iacopo	ㅇㅣㅇㅏㅋㅗㅍㅗ
corin	ㅋㅗㄹㅣㄴ
adler	ㅇㅏㄷㅡㄹㄹㅓ
zimmermann	ㅊㅣㅁㅓㅁㅏㄴ
ismail	ㅇㅣㅅㅡㅁㅏㅇㅣㄹ
tania	ㅌㅏㄴㅣㅇㅏ
katie	ㅋㅔㅇㅣㅌㅣ
macintyre	ㅁㅐㅋㅣㄴㅌㅏㅇㅣㅇㅓ
hauser	ㅎㅏㅇㅜㅈㅓ
benedict	ㅂㅔㄴㅔㄷㅣㄱㅌㅡ
karolina	ㅋㅏㄹㅗㄹㄹㅣㄴㅏ
marley	ㅁㅏㄹㄹㅣ
alireza	ㅇㅏㄹㄹㅣㄹㅔㅈㅏ
clovis	ㅋㅡㄹㄹㅗㅂㅣㅅㅡ
ronan	ㄹㅗㄴㅓㄴ
moacir	ㅁㅗㅇㅏㅅㅣㄹㅡ
downie	ㄷㅏㅇㅜㄴㅣ
lynda	ㄹㅣㄴㄷㅏ
kenyon	ㅋㅔㄴㅕㄴ
hodgkin	ㅎㅗㅈㅣㅋㅣㄴ
rawlings	ㄹㅗㄹㄹㅣㅇㅅㅡ
cassel	ㅋㅏㅅㅔㄹ
hoxha	ㅎㅗㅈㅏ
arteaga	ㅇㅏㄹㅡㅌㅔㅇㅏㄱㅏ
redgrave	ㄹㅔㄷㅡㄱㅡㄹㅔㅇㅣㅂㅡ
lawson	ㄹㅗㅅㅡㄴ
georg	ㄱㅔㅇㅗㄹㅡㅋㅡ
susana	ㅅㅜㅅㅏㄴㅏ
wynn	ㅇㅟㄴ
markus	ㅁㅏㄹㅡㅋㅜㅅㅡ
dermot	ㄷㅓㅁㅓㅅ
aiden	ㅇㅔㅇㅣㄷㅡㄴ
carolina	ㅋㅏㄹㅗㄹㄹㅣㄴㅏ
sadakatsu	ㅅㅏㄷㅏㅋㅏㅆㅡ
hank	ㅎㅐㅇㅋㅡ
golden	ㄱㅗㄹㄷㅡㄴ
mensah	ㅁㅔㄴㅅㅏ
tilson	ㅌㅣㄹㅅㅡㄴ
camille	ㅋㅏㅁㅣㅇㅠ
nico	ㄴㅣㅋㅗ
pompidou	ㅍㅗㅇㅍㅣㄷㅜ
gortat	ㄱㅗㅌㅏㅅ
kaj	ㅋㅏㅇㅣ
kimberley	ㅋㅣㅁㅂㅓㄹㄹㅣ
parrish	ㅍㅐㄹㅣㅅㅣ
chilperic	ㅎㅣㄹㅍㅔㄹㅣㅎㅣ
jerome	ㅈㅔㄹㅗㅁ
shigeru	ㅅㅣㄱㅔㄹㅜ
oka	ㅇㅗㅋㅏ
pyotr	ㅍㅛㅌㅡㄹㅡ
salgado	ㅅㅏㄹㄱㅏㄷㅗ
amir	ㅇㅏㅁㅣㄹㅡ
matthias	ㅁㅏㅌㅣㅇㅏㅅㅡ
ariane	ㅇㅏㄹㅣㅇㅏㄴ
rasmus	ㄹㅏㅅㅡㅁㅜㅅㅡ
rudy	ㄹㅜㄷㅣ
darya	ㄷㅏㄹㅣㅇㅑ
blackburn	ㅂㅡㄹㄹㅐㄱㅂㅓㄴ
ina	ㅇㅣㄴㅏ
steven	ㅅㅡㅌㅣㅂㅡㄴ
feder	ㅍㅔㄷㅓ
prior	ㅍㅡㄹㅏㅇㅣㅇㅓ
april	ㅇㅔㅇㅣㅍㅡㄹㅣㄹ
mccartney	ㅁㅐㅋㅏㅌㅡㄴㅣ
coburn	ㅋㅗㅂㅓㄴ
anthony	ㅇㅐㄴㅅㅓㄴㅣ
adrien	ㅇㅏㄷㅡㄹㅣㅇㅏㅇ
lorne	ㄹㅗㄴ
granger	ㄱㅡㄹㅔㅇㅣㄴㅈㅓ
quinlan	ㅋㅟㄴㄹㅓㄴ
emile	ㅇㅔㅁㅣㄹ
roxas	ㄹㅗㅎㅏㅅㅡ
theodore	ㅅㅣㅇㅓㄷㅗㅇㅓ
ayub	ㅇㅏㅇㅠㅂㅡ
baker	ㅂㅔㅇㅣㅋㅓ
megyn	ㅁㅔㄱㅣㄴ
flora	ㅍㅡㄹㄹㅗㄹㅏ
margarethe	ㅁㅏㄱㅏㄹㅔㅌㅔ
mcphee	ㅁㅐㄱㅍㅣ
elmer	ㅇㅔㄹㅁㅓ
maier	ㅁㅏㅇㅣㅇㅓ
rocha	ㅎㅗㅅㅑ
pius	ㅍㅣㅇㅜㅅㅡ
ewelina	ㅇㅔㅂㅔㄹㄹㅣㄴㅏ
eye	ㅇㅏㅇㅣ
bain	ㅂㅔㅇㅣㄴ
ross	ㄹㅗㅅㅡ
damon	ㄷㅔㅇㅣㅁㅓㄴ
rodriguez	ㄹㅗㄷㅡㄹㅣㄱㅔㅅㅡ
hansson	ㅎㅏㄴㅅㅗㄴ
helena	ㅎㅔㄹㄹㅔㄴㅏ
solo	ㅅㅗㄹㄹㅗ
horner	ㅎㅗㄴㅓ
beckford	ㅂㅔㄱㅍㅓㄷㅡ
lobsang	ㄹㅗㅂㅅㅏㅇ
shakespeare	ㅅㅖㅇㅣㄱㅅㅡㅍㅣㅇㅓ
hayashi	ㅎㅏㅇㅑㅅㅣ
valeriya	ㅂㅏㄹㄹㅔㄹㅣㅇㅑ
neferirkare	ㄴㅔㅍㅔㄹㅣㄹㅡㅋㅏㄹㅔ
masatoshi	ㅁㅏㅅㅏㅌㅗㅅㅣ
swanson	ㅅㅡㅇㅘㄴㅅㅡㄴ
kaya	ㅋㅏㅇㅑ
yehuda	ㅇㅖㅎㅜㄷㅏ
crawford	ㅋㅡㄹㅗㅍㅓㄷㅡ
mikel	ㅁㅣㅋㅔㄹ
antonelli	ㅇㅏㄴㅌㅗㄴㅔㄹㄹㅣ
pontus	ㅍㅗㄴㅌㅜㅅㅡ
austen	ㅇㅗㅅㅡㅌㅣㄴ
ortiz	ㅇㅗㄹㅡㅌㅣㅅㅡ
mona	ㅁㅗㄴㅏ
rebrov	ㄹㅔㅂㅡㄹㅗㅍㅡ
eero	ㅇㅔㄹㅗ
valentinian	ㅂㅏㄹㄹㅔㄴㅌㅣㄴㅣㅇㅏㄴㅜㅅㅡ
kimball	ㅋㅣㅁㅂㅗㄹ
lamar	ㄹㅏㅁㅏ
hoover	ㅎㅜㅂㅓ
tejada	ㅌㅔㅎㅏㄷㅏ
burns	ㅂㅓㄴㅅㅡ
sohee	ㅅㅗㅎㅢ
geoff	ㅈㅔㅍㅡ
vien	ㅂㅣㅇㅔㄴ
cristiano	ㅋㅡㄹㅣㅅㅡㅌㅣㅇㅏㄴㅗ
elena	ㅇㅔㄹㄹㅔㄴㅏ
schwarz	ㅅㅠㅂㅏㄹㅡㅊㅡ
bevan	ㅂㅔㅂㅓㄴ
carme	ㅋㅏㄹㅡㅁㅔ
carlyle	ㅋㅏㄹㄹㅏㅇㅣㄹ
lykke	ㄹㅟㅋㅔ
punch	ㅍㅓㄴㅊㅣ
waugh	ㅇㅝ
vos	ㅂㅗㅅㅡ
rube	ㄹㅜㅂㅡ
sergei	ㅅㅔㄹㅡㄱㅔㅇㅣ
vsevolod	ㅍㅡㅅㅔㅂㅗㄹㄹㅗㅌㅡ
ochoa	ㅇㅗㅊㅗㅇㅏ
khalil	ㅋㅏㄹㄹㅣㄹ
zita	ㅈㅣㅌㅏ
mike	ㅁㅏㅇㅣㅋㅡ
risi	ㄹㅣㅅㅣ
vassily	ㅂㅏㅅㅣㄹㄹㅣ
smith	ㅅㅡㅁㅣㅅㅡ
serna	ㅅㅔㄹㅡㄴㅏ
kerry	ㅋㅔㄹㅣ
sayaka	ㅇㅏㅇㅗㅋㅣ
on	ㅇㅗㄴ
madden	ㅁㅐㄷㅡㄴ
halfpenny	ㅎㅏㅍㅡㅍㅔㄴㅣ
guadalupe	ㄱㅘㄷㅏㄹㄹㅜㅍㅔ
malakian	ㅁㅏㄹㄹㅏㅋㅣㅇㅏㄴ
babenko	ㅂㅏㅂㅔㄴㅋㅗ
fielder	ㅍㅣㄹㄷㅓ
yumi	ㅇㅠㅁㅣ
barney	ㅂㅏㄴㅣ
sokratis	ㅅㅗㅋㅡㄹㅏㅌㅣㅅㅡ
allie	ㅇㅐㄹㄹㅣ
sanada	ㅅㅏㄴㅏㄷㅏ
musa	ㅁㅜㅅㅏ
holliday	ㅎㅗㄹㄹㅣㄷㅔㅇㅣ
easton	ㅇㅣㅅㅡㅌㅓㄴ
field	ㅍㅣㄹㄷㅡ
ulmanis	ㅇㅜㄹㅁㅏㄴㅣㅅㅡ
baum	ㅂㅏㅇㅜㅁ
mollie	ㅁㅗㄹㄹㅣ
piotr	ㅍㅣㅇㅗㅌㅡㄹㅡ
garvey	ㄱㅏㅂㅣ
paolo	ㅍㅏㅇㅗㄹㄹㅗ
homer	ㅎㅗㅁㅓ
seiji	ㄱㅗㅂㅏㅇㅑㅅㅣ
kat	ㅋㅐㅅ
dickerson	ㄷㅣㅋㅓㅅㅡㄴ
saudi	ㅇㅏㅂㄷㅜㄹ
tyson	ㅌㅏㅇㅣㅅㅡㄴ
caesar	ㅋㅏㅇㅣㅅㅏㄹㅡ
fields	ㅍㅣㄹㅈㅡ
paulino	ㅍㅏㅇㅜㄹㄹㅣㄴㅗ
mitra	ㅁㅣㅌㅡㄹㅏ
england	ㅇㅣㅇㄱㅡㄹㄹㅐㄴㄷㅡ
faouzi	ㅍㅏㅇㅜㅈㅣ
amancio	ㅇㅏㅁㅏㄴㅅㅣㅇㅗ
marceau	ㅁㅏㄹㅡㅅㅗ
ludmila	ㄹㅜㄷㅡㅁㅣㄹㄹㅏ
willi	ㅂㅣㄹㄹㅣ
talia	ㅌㅏㄹㄹㅣㅇㅏ
maurizio	ㅁㅏㅇㅜㄹㅣㅊㅣㅇㅗ
shepard	ㅅㅖㅍㅓㄷㅡ
cathy	ㅋㅐㅅㅣ
islam	ㅇㅣㅅㅡㄹㄹㅏㅁ
loretta	ㄹㅗㄹㅔㅌㅏ
kati	ㅋㅏㅌㅣ
cesare	ㅊㅔㅅㅏㄹㅔ
stinson	ㅅㅡㅌㅣㄴㅅㅡㄴ
minoru	ㅁㅣㄴㅗㄹㅜ
inge	ㅇㅣㅇㅇㅓ
stowe	ㅅㅡㅌㅗ
ice	ㅇㅏㅇㅣㅅㅡ
potenza	ㅍㅗㅌㅔㄴㅊㅏ
razak	ㄹㅏㅈㅏㄱ
pantelis	ㅍㅏㄴㅌㅔㄹㄹㅣㅅㅡ
rubens	ㄹㅜㅂㅔㄴㅅㅡ
static	ㅅㅡㅌㅐㅌㅣㄱ
persakis	ㅍㅔㄹㅡㅅㅏㅋㅣㅅㅡ
myles	ㅁㅏㅇㅣㄹㅅㅡ
sahib	ㅅㅏㅎㅣㅂ
rosa	ㅎㅗㅈㅏ
gautier	ㄱㅗㅌㅣㅇㅔ
menachem	ㅁㅔㄴㅏㅎㅔㅁ
skye	ㅅㅡㅋㅏㅇㅣ
bizzy	ㅂㅣㅈㅣ
phoenix	ㅍㅣㄴㅣㄱㅅㅡ
naser	ㄴㅏㅅㅔㄹㅡ
norton	ㄴㅗㅌㅓㄴ
gul	ㄱㅜㄹ
guerrero	ㄱㅔㄹㅔㄹㅗ
boyko	ㅂㅗㅇㅣㅋㅗ
vartan	ㅂㅏㄹㅡㅌㅏㅇ
abigail	ㅇㅐㅂㅣㄱㅔㅇㅣㄹ
misha	ㅁㅣㅅㅑ
tanner	ㅌㅐㄴㅓ
tsugumichi	ㅆㅡㄱㅜㅁㅣㅊㅣ
valance	ㅂㅐㄹㄹㅓㄴㅅㅡ
paul	ㅍㅗㄹ
marko	ㅁㅏㄹㅡㅋㅗ
woodrow	ㅇㅜㄷㅡㄹㅗ
nasser	ㄴㅏㅅㅔㄹㅡ
schumer	ㅅㅠㅁㅓ
pooja	ㅍㅜㅈㅏ
giampiero	ㅈㅏㅁㅍㅣㅇㅔㄹㅗ
sinatra	ㅅㅣㄴㅏㅌㅡㄹㅏ
wooldridge	ㅇㅜㄹㄷㅡㄹㅣㅈㅣ
spears	ㅅㅡㅍㅣㅇㅓㅅㅡ
latif	ㄹㅏㅌㅣㅍㅡ
moscoso	ㅁㅗㅅㅡㅋㅗㅅㅗ
rota	ㄹㅗㅌㅏ
waterhouse	ㅇㅝㅌㅓㅎㅏㅇㅜㅅㅡ
carolyn	ㅋㅐㄹㅓㄹㄹㅣㄴ
vipsanius	ㅂㅣㅂㅅㅏㄴㅣㅇㅜㅅㅡ
umberto	ㅇㅜㅁㅂㅔㄹㅡㅌㅗ
abbie	ㅇㅐㅂㅣ
asano	ㅇㅏㅅㅏㄴㅗ
sinclair	ㅅㅣㅇㅋㅡㄹㄹㅔㅇㅓ
preston	ㅍㅡㄹㅔㅅㅡㅌㅓㄴ
norodom	ㄴㅗㄹㅗㄷㅗㅁ
naismith	ㄴㅔㅇㅣㅅㅡㅁㅣㅅㅡ
stylianos	ㅅㅡㅌㅣㄹㄹㅣㅇㅏㄴㅗㅅㅡ
ava	ㅇㅔㅇㅣㅂㅏ
sisto	ㅅㅣㅅㅡㅌㅗ
schmid	ㅅㅠㅁㅣㄷㅡ
tadafusa	ㄷㅏㄷㅏㅎㅜㅅㅏ
dreyfus	ㄷㅡㄹㅔㅍㅟㅅㅡ
isabella	ㅇㅣㅅㅏㅂㅔㄹㄹㅏ
kumar	ㅋㅜㅁㅏㄹㅡ
sanders	ㅅㅐㄴㄷㅓㅅㅡ
sung	ㅅㅓㅇ
arthur	ㅇㅏㅅㅓ
leonardo	ㄹㅔㅇㅗㄴㅏㄹㅡㄷㅗ
justinian	ㅇㅠㅅㅡㅌㅣㄴㅣㅇㅏㄴㅜㅅㅡ
weiner	ㅇㅟㄴㅓ
geiger	ㄱㅏㅇㅣㄱㅓ
constantine	ㅋㅗㄴㅅㅡㅌㅏㄴㅌㅣㄴㅜㅅㅡ
glazer	ㄱㅡㄹㄹㅔㅇㅣㅈㅓ
stone	ㅅㅡㅌㅗㄴ
edward	ㅇㅔㄷㅡㅇㅝㄷㅡ
gallacher	ㄱㅐㄹㄹㅓㅊㅓ
sforza	ㅅㅡㅍㅗㄹㅡㅊㅏ
madison	ㅁㅐㄷㅣㅅㅡㄴ
dmitry	ㄷㅡㅁㅣㅌㅡㄹㅣ
miku	ㅌㅏㄴㅏㅋㅏ
cuevas	ㅋㅜㅇㅔㅂㅏㅅㅡ
lintz	ㄹㅣㄴㅊㅡ
ludovic	ㄹㅟㄷㅗㅂㅣㅋㅡ
marrone	ㅁㅏㄹㅗㄴㅔ
agnelli	ㅇㅏㄴㅖㄹㄹㅣ
jorge	ㅎㅗㄹㅡㅎㅔ
farmer	ㅍㅏㅁㅓ
gustave	ㄱㅟㅅㅡㅌㅏㅂㅡ
blake	ㅂㅡㄹㄹㅔㅇㅣㅋㅡ
mucha	ㅁㅜㅎㅏ
bauer	ㅂㅏㅇㅜㅇㅓ
erna	ㅇㅔㄹㅡㄴㅏ
antje	ㅇㅏㄴㅌㅖ
roddick	ㄹㅗㄷㅣㄱ
veneziano	ㅂㅔㄴㅔㅊㅣㅇㅏㄴㅗ
ricketts	ㄹㅣㅋㅔㅊㅡ
zeba	ㅈㅔㅂㅏ
lauren	ㄹㅗㄹㅓㄴ
torsten	ㅌㅗㄹㅡㅅㅡㅌㅔㄴ
ruby	ㄹㅜㅂㅣ
amini	ㅇㅏㅁㅣㄴㅣ
bode	ㅂㅗㄷㅔ
dalton	ㄷㅗㄹㅌㅓㄴ
briggs	ㅂㅡㄹㅣㄱㅅㅡ
arnuwanda	ㅇㅏㄹㅡㄴㅜㅇㅘㄴㄷㅏ
byrd	ㅂㅓㄷㅡ
pasquale	ㅍㅏㅅㅡㅋㅘㄹㄹㅔ
yisrael	ㅇㅣㅅㅡㄹㅏㅇㅔㄹ
yung	ㅇㅕㅇ
ridley	ㄹㅣㄷㅡㄹㄹㅣ
cass	ㅋㅐㅅㅡ
hawley	ㅎㅗㄹㄹㅣ
julen	ㅎㅜㄹㄹㅔㄴ
lesser	ㄹㅔㅅㅓ
mattia	ㅁㅏㅌㅣㅇㅏ
sakho	ㅅㅏㅋㅗ
steel	ㅅㅡㅌㅣㄹ
zola	ㅈㅗㄹㄹㅏ
camila	ㅋㅏㅁㅣㄹㄹㅏ
jonatan	ㅇㅛㄴㅏㅌㅏㄴ
coleman	ㅋㅗㄹㅁㅓㄴ
diogo	ㅈㅣㅇㅗㄱㅜ
gummer	ㄱㅓㅁㅓ
volkan	ㅂㅗㄹㅋㅏㄴ
elina	ㅇㅔㄹㄹㅣㄴㅏ
rousseau	ㄹㅜㅅㅗ
gallego	ㄱㅏㅇㅖㄱㅗ
sengoku	ㅅㅔㄴㄱㅗㅋㅜ
alain	ㅇㅏㄹㄹㅐㅇ
delta	ㄷㅔㄹㅌㅏ
nobuoki	ㄴㅗㅂㅜㅇㅗㅋㅣ
caitlyn	ㅋㅔㅇㅣㅌㅡㄹㄹㅣㄴ
windsor	ㅇㅟㄴㅈㅓ
river	ㄹㅣㅂㅓ
gale	ㄱㅔㅇㅣㄹ
bertini	ㅂㅔㄹㅡㅌㅣㄴㅣ
brigham	ㅂㅡㄹㅣㄱㅓㅁ
khaled	ㅋㅏㄹㄹㅔㄷㅡ
af	ㅇㅏㅍㅡ
liza	ㄹㅣㅈㅏ
ozaki	ㅇㅠㅋㅣㅇㅗ
marcantonio	ㅁㅏㄹㅡㅋㅏㄴㅌㅗㄴㅣㅇㅗ
els	ㅇㅔㄹㅅㅡ
leighton	ㄹㅔㅇㅣㅌㅓㄴ
buff	ㅂㅓㅍㅡ
hossein	ㅎㅗㅅㅔㅇㅣㄴ
kal	ㅋㅏㄹ
zviad	ㅈㅡㅂㅣㅇㅏㄷㅡ
karim	ㅋㅏㄹㅣㅁ
almond	ㅇㅏㄹㅁㅗㄴㄷㅡ
po	ㅍㅗ
dijkstra	ㄷㅔㅇㅣㅋㅡㅅㅡㅌㅡㄹㅏ
acker	ㅇㅐㅋㅓ
nagayasu	ㄴㅏㄱㅏㅇㅑㅅㅡ
gillies	ㄱㅣㄹㄹㅣㅅㅡ
herb	ㅎㅓㅂㅡ
magdalena	ㅁㅏㄱㅡㄷㅏㄹㄹㅔㄴㅏ
lotte	ㄹㅗㅌㅔ
nomi	ㄴㅗㅁㅣ
sadi	ㅅㅏㄷㅣ
browne	ㅂㅡㄹㅏㅇㅜㄴ
jahn	ㅇㅑㄴ
dolph	ㄷㅗㄹㅍㅡ
huston	ㅎㅠㅅㅡㅌㅓㄴ
brando	ㅂㅡㄹㅐㄴㄷㅗ
mela	ㅁㅔㄹㄹㅏ
foy	ㅍㅗㅇㅣ
kathryn	ㅋㅐㅅㅡㄹㅣㄴ
anne	ㅇㅐㄴ
gerry	ㄱㅔㄹㅣ
ho	ㅎㅗ
hui	ㅎㅜㅇㅣ
esteves	ㅇㅔㅅㅡㅌㅔㅂㅔㅅㅡ
reynolds	ㄹㅔㅇㅣㄴㅗㄹㅈㅡ
raul	ㄹㅏㅇㅜㄹ
donati	ㄷㅗㄴㅏㅌㅣ
darcy	ㄷㅏㅅㅣ
samir	ㅅㅏㅁㅣㄹㅡ
bellisario	ㅂㅔㄹㄹㅣㅅㅏㄹㅣㅇㅗ
naotaka	ㄴㅏㅇㅗㅌㅏㅋㅏ
barbarigo	ㅂㅏㄹㅡㅂㅏㄹㅣㄱㅗ
toshihiko	ㅇㅜㅊㅣㅇㅑㅁㅏ
kirsten	ㅋㅓㅅㅡㅌㅣㄴ
lebedev	ㄹㅔㅂㅔㄷㅔㅍㅡ
china	ㅊㅏㅇㅣㄴㅏ
alden	ㅇㅗㄹㄷㅡㄴ
nicks	ㄴㅣㄱㅅㅡ
jessica	ㅈㅔㅅㅣㅋㅏ
emma	ㅇㅔㅁㅏ
ellis	ㅇㅔㄹㄹㅣㅅㅡ
marius	ㅁㅏㄹㅣㅇㅜㅅㅡ
lofting	ㄹㅗㅍㅡㅌㅣㅇ
baptista	ㅂㅏㅍㅡㅌㅣㅅㅡㅌㅏ
taavi	ㅌㅏㅂㅣ
stevens	ㅅㅡㅌㅣㅂㅡㄴㅅㅡ
pausanias	ㅍㅏㅇㅜㅅㅏㄴㅣㅇㅏㅅㅡ
tarver	ㅌㅏㅂㅓ
atsushi	ㅇㅣㅌㅗ
finley	ㅍㅣㄴㄹㅣ
dasha	ㄷㅏㅅㅑ
ruud	ㄹㅟㅌㅡ
orsini	ㅇㅗㄹㅡㅅㅣㄴㅣ
henri	ㅇㅏㅇㄹㅣ
carnegie	ㅋㅏㄴㅔㄱㅣ
kher	ㅋㅓ
aitor	ㅇㅏㅇㅣㅌㅗㄹㅡ
yasin	ㅇㅑㅅㅣㄴ
burgess	ㅂㅓㅈㅣㅅㅡ
nielsen	ㄴㅣㄹㅅㅔㄴ
gould	ㄱㅜㄹㄷㅡ
raquel	ㄹㅏㅋㅔㄹ
ladislav	ㄹㅏㄷㅣㅅㅡㄹㄹㅏㅍㅡ
demba	ㄷㅔㅁㅂㅏ
mccann	ㅁㅐㅋㅐㄴ
mcneill	ㅁㅐㄱㄴㅣㄹ
north	ㄴㅗㅅㅡ
tsuda	ㅆㅡㄷㅏ
gardner	ㄱㅏㄷㅡㄴㅓ
pizarro	ㅍㅣㅅㅏㄹㅗ
sandri	ㅅㅏㄴㄷㅡㄹㅣ
sierra	ㅅㅣㅇㅔㄹㅏ
doc	ㄷㅗㄱ
koch	ㅋㅗㅎㅡ
simpson	ㅅㅣㅁㅍㅡㅅㅡㄴ
uche	ㅇㅜㅊㅔ
napier	ㄴㅔㅇㅣㅍㅣㅇㅓ
oishi	ㄴㅗㅂㅜㅇㅠㅋㅣ
lachey	ㄹㅓㅅㅖㅇㅣ
schwarzenegger	ㅅㅠㅇㅝㅈㅔㄴㅔㄱㅓ
mccall	ㅁㅐㅋㅗㄹ
cataldi	ㅋㅏㅌㅏㄹㄷㅣ
jemima	ㅈㅔㅁㅣㅁㅏ
phuntsog	ㅍㅜㄴㅊㅗㄱㅡ
elisa	ㅇㅔㄹㄹㅣㅅㅏ
boer	ㅂㅜㄹㅡ
curry	ㅋㅓㄹㅣ
patrice	ㅍㅏㅌㅡㄹㅣㅅㅡ
mihaela	ㅁㅣㅎㅏㅇㅔㄹㄹㅏ
farr	ㅍㅏ
marion	ㅁㅐㄹㅣㅇㅓㄴ
ziering	ㅈㅣㄹㅣㅇ
takeda	ㄷㅏㅋㅔㄷㅏ
knowles	ㄴㅗㄹㅅㅡ
alessandra	ㅇㅏㄹㄹㅔㅅㅏㄴㄷㅡㄹㅏ
givens	ㄱㅣㅂㅡㄴㅅㅡ
wise	ㅇㅘㅇㅣㅈㅡ
soraya	ㅅㅗㄹㅏㅇㅑ
carmelo	ㅋㅏㄹㅡㅁㅔㄹㄹㅗ
linger	ㄹㅣㅇㄱㅓ
arun	ㅇㅏㄹㅜㄴ
licinius	ㄹㅣㅋㅣㄴㅣㅇㅜㅅㅡ
baptiste	ㅂㅏㅂㅌㅣㅅㅡㅌㅡ
charlene	ㅅㅑㄹㄹㅣㄴ
katz	ㅋㅏㅊㅡ
adam	ㅇㅐㄷㅓㅁ
garcia	ㄱㅏㄹㅡㅅㅣㅇㅏ
modigliani	ㅁㅗㄷㅣㄹㄹㅣㅇㅏㄴㅣ
sean	ㅅㅛㄴ
roque	ㅎㅗㅋㅔ
souleymane	ㅅㅜㄹㄹㅔㅁㅏㄴ
torres	ㅌㅗㄹㅔㅅㅡ
deschanel	ㄷㅔㅇㅣㅅㅕㄴㅔㄹ
pitts	ㅍㅣㅊㅡ
naples	ㄴㅏㅍㅗㄹㄹㅣ
nils	ㄴㅣㄹㅅㅡ
nolan	ㄴㅗㄹㄹㅓㄴ
braga	ㅂㅡㄹㅏㄱㅏ
ameobi	ㅇㅏㅁㅔㅇㅗㅂㅣ
diane	ㄷㅏㅇㅣㅇㅐㄴ
theda	ㅌㅔㄷㅏ
berezutski	ㅂㅔㄹㅔㅈㅜㅊㅡㅋㅣ
marston	ㅁㅏㅅㅡㅌㅓㄴ
tola	ㅌㅗㄹㄹㅏ
low	ㄹㅗㅇㅜ
jos	ㅇㅛㅅㅡ
farrah	ㅍㅏㄹㅏ
katsuie	ㄱㅏㅆㅡㅇㅣㅇㅔ
grayson	ㄱㅡㄹㅔㅇㅣㅅㅡㄴ
bigelow	ㅂㅣㄱㅡㄹㄹㅗ
mackie	ㅁㅐㅋㅣ
mirko	ㅁㅣㄹㅡㅋㅗ
vassilios	ㅂㅏㅅㅣㄹㄹㅣㅇㅗㅅㅡ
nobuzane	ㄴㅗㅂㅜㅈㅏㄴㅔ
luciano	ㄹㅜㅅㅣㅇㅏㄴㅗ
cheek	ㅊㅣㅋㅡ
gloria	ㄱㅡㄹㄹㅗㄹㅣㅇㅏ
rachel	ㄹㅔㅇㅣㅊㅓㄹ
carter	ㅋㅏㅌㅓ
emily	ㅇㅔㅁㅣㄹㄹㅣ
cheick	ㅅㅖㅇㅣㅋㅡ
watson	ㅇㅘㅅㅅㅡㄴ
guillaume	ㄱㅣㅇㅛㅁ
goebel	ㄱㅚㅂㅔㄹ
owain	ㅇㅗㅇㅞㅇㅣㄴ
karimi	ㅋㅏㄹㅣㅁㅣ
tomi	ㅌㅗㅁㅣ
leyva	ㄹㅔㅇㅣㅂㅏ
nathan	ㄴㅔㅇㅣㅅㅓㄴ
atsuji	ㅇㅏㅊㅡㅈㅣ
cecil	ㅅㅔㅅㅣㄹ
algernon	ㅇㅐㄹㅈㅓㄴㅓㄴ
steen	ㅅㅡㅌㅔㄴ
eduardo	ㅇㅔㄷㅜㅇㅏㄹㅡㄷㅗ
dexter	ㄷㅔㄱㅅㅡㅌㅓ
malipiero	ㅁㅏㄹㄹㅣㅍㅣㅇㅔㄹㅗ
ioan	ㅇㅣㅇㅗㅇㅏㄴ
burt	ㅂㅓㅌㅡ
kruse	ㅋㅡㄹㅜㅈㅔ
shankar	ㅅㅑㅇㅋㅏㄹㅡ
gottlob	ㄱㅗㅌㅡㄹㄹㅗㅍㅡ
marie	ㅁㅏㄹㅣ
mia	ㅁㅣㅇㅏ
norimasa	ㄴㅗㄹㅣㅁㅏㅅㅏ
dario	ㄷㅏㄹㅣㅇㅗ
steno	ㅅㅡㅌㅔㄴㅗ
bouazizi	ㅂㅜㅇㅏㅈㅣㅈㅣ
carloman	ㅋㅏㄹㅡㄹㄹㅗㅁㅏㄴ
chadwick	ㅊㅐㄷㅡㅇㅟㄱ
rossum	ㄹㅗㅅㅓㅁ
ennis	ㅇㅔㄴㅣㅅㅡ
thomson	ㅌㅗㅁㅅㅡㄴ
kobayashi	ㅇㅠㅋㅣ
roosevelt	ㄹㅜㅅㅡㅂㅔㄹㅌㅡ
dejan	ㄷㅔㅇㅑㄴ
morrow	ㅁㅗㄹㅗ
healy	ㅎㅣㄹㄹㅣ
bar	ㅂㅏㄹㅡ
lita	ㄹㅣㅌㅏ
yakubu	ㅇㅑㅋㅜㅂㅜ
mckenna	ㅁㅐㅋㅔㄴㅏ
freddy	ㅍㅡㄹㅔㄷㅣ
jonas	ㅇㅛㄴㅏㅅㅡ
martini	ㅁㅏㄹㅡㅌㅣㄴㅣ
aiko	ㅇㅏㅇㅣㅋㅗ
wozniak	ㅇㅝㅈㅡㄴㅣㅇㅏㄱ
pollock	ㅍㅗㄹㄹㅗㄱ
damien	ㄷㅔㅇㅣㅁㅣㅇㅓㄴ
columbus	ㅋㅗㄹㄹㅓㅁㅂㅓㅅㅡ
aigars	ㅇㅏㅇㅣㄱㅏㄹㅡㅅㅡ
cousteau	ㅋㅜㅅㅡㅌㅗ
dunbar	ㄷㅓㄴㅂㅏ
ric	ㄹㅣㄱ
andrej	ㅇㅏㄴㄷㅡㄹㅔㅇㅣ
mcbride	ㅁㅐㄱㅂㅡㄹㅏㅇㅣㄷㅡ
delphine	ㄷㅔㄹㅍㅣㄴ
birkir	ㅂㅣㄹㅡㅋㅣㄹㅡ
euthydemus	ㅇㅔㅇㅜㅌㅣㄷㅔㅁㅗㅅㅡ
blue	ㅂㅡㄹㄹㅜ
mata	ㅁㅏㅌㅏ
torii	ㄷㅗㄹㅣㅇㅣ
fujita	ㅎㅜㅈㅣㅌㅏ
michaela	ㅁㅣㅋㅏㅇㅔㄹㄹㅏ
takumi	ㅎㅏㅅㅣㅁㅗㅌㅗ
daddario	ㄷㅏㄷㅏㄹㅣㅇㅗ
caroline	ㅋㅐㄹㅓㄹㄹㅏㅇㅣㄴ
yury	ㅇㅠㄹㅣ
ira	ㅇㅏㅇㅣㄹㅏ
castillo	ㅋㅏㅅㅡㅌㅣㅇㅛ
masina	ㅁㅏㅅㅣㄴㅏ
mcevoy	ㅁㅐㄱㅇㅓㅂㅗㅇㅣ
kubert	ㅋㅠㅂㅓㅌㅡ
torri	ㅌㅗㄹㅣ
alen	ㅇㅏㄹㄹㅔㄴ
haworth	ㅎㅏㅇㅝㅅㅡ
yamagata	ㅇㅑㅁㅏㄱㅏㅌㅏ
taymazov	ㅌㅏㅇㅣㅁㅏㅈㅗㅍㅡ
athanasios	ㅇㅏㅌㅏㄴㅏㅅㅣㅇㅗㅅㅡ
colfer	ㅋㅗㄹㅍㅓ
schlesinger	ㅅㅠㄹㄹㅔㅈㅣㄴㅈㅓ
muhammad	ㅁㅜㅎㅏㅁㅁㅏㄷㅡ
weld	ㅇㅞㄹㄷㅡ
orser	ㅇㅗㅅㅓ
eemil	ㅇㅔㅁㅣㄹ
just	ㅈㅓㅅㅡㅌㅡ
juho	ㅇㅠㅎㅗ
schrader	ㅅㅠㄹㅏㄷㅓ
massaro	ㅁㅏㅅㅏㄹㅗ
compton	ㅋㅗㅁㅍㅡㅌㅓㄴ
chapman	ㅊㅐㅍㅡㅁㅓㄴ
andrews	ㅇㅐㄴㄷㅡㄹㅜㅅㅡ
antoine	ㅇㅏㅇㅌㅜㅇㅏㄴ
werner	ㅂㅔㄹㅡㄴㅓ
koller	ㅋㅗㄹㄹㅔㄹㅡ
bohosiewicz	ㅂㅗㅎㅗㅅㅣㅇㅔㅂㅣㅊㅣ
jodi	ㅈㅗㄷㅣ
mcauliffe	ㅁㅐㅋㅗㄹㄹㅣㅍㅡ
litvinova	ㄹㅣㅌㅡㅂㅣㄴㅗㅂㅏ
amelia	ㅇㅏㅁㅔㄹㄹㅣㅇㅏ
palmeiro	ㅍㅏㄹㅁㅔㅇㅣㄹㅗ
christopoulos	ㅎㅡㄹㅣㅅㅡㅌㅗㅍㅜㄹㄹㅗㅅㅡ
monti	ㅁㅗㄴㅌㅣ
romo	ㄹㅗㅁㅗ
gertrude	ㄱㅓㅌㅡㄹㅜㄷㅡ
pryor	ㅍㅡㄹㅏㅇㅣㅇㅓ
nepos	ㄴㅔㅍㅗㅅㅡ
eileen	ㅇㅏㅇㅣㄹㄹㅣㄴ
loewe	ㄹㅚㅂㅔ
yacine	ㅇㅑㅅㅣㄴ
delgado	ㄷㅔㄹㄱㅏㄷㅗ
miralem	ㅁㅣㄹㅏㄹㄹㅔㅁ
saleh	ㅅㅏㄹㄹㅔ
shephard	ㅅㅖㅍㅓㄷㅡ
iveta	ㅇㅣㅂㅔㅌㅏ
kutuzov	ㅋㅜㅌㅜㅈㅗㅍㅡ
cross	ㅋㅡㄹㅗㅅㅡ
takagi	ㅅㅠㄴ
osvaldo	ㅇㅗㅅㅡㅂㅏㄹㄷㅗ
pendleton	ㅍㅔㄴㄷㅡㄹㅌㅓㄴ
sami	ㅅㅏㅁㅣ
hjort	ㅇㅛㄹㅡㅌㅡ
blum	ㅂㅡㄹㄹㅜㅁ
belushi	ㅂㅔㄹㄹㅜㅅㅣ
sol	ㅅㅗㄹ
leandro	ㄹㅔㅇㅏㄴㄷㅡㄹㅜ
france	ㅍㅡㄹㅏㅇㅅㅡ
sanetsune	ㅅㅏㄴㅔㅆㅡㄴㅔ
carina	ㅋㅏㄹㅣㄴㅏ
leto	ㄹㅔㅌㅗ
houser	ㅎㅏㅇㅜㅈㅓ
dietmar	ㄷㅣㅌㅡㅁㅏㄹㅡ
ramiro	ㄹㅏㅁㅣㄹㅗ
goran	ㄱㅗㄹㅏㄴ
rabe	ㄹㅔㅇㅣㅂㅡ
trujillo	ㅌㅡㄹㅜㅎㅣㅇㅛ
rosalind	ㄹㅗㅈㅓㄹㄹㅣㄴㄷㅡ
debbie	ㄷㅔㅂㅣ
adrienne	ㅇㅔㅇㅣㄷㅡㄹㅣㅇㅔㄴ
yan	ㅇㅑㄴ
joy	ㅈㅗㅇㅣ
kazan	ㅋㅏㅈㅏㄴ
culkin	ㅋㅓㄹㅋㅣㄴ
ingmann	ㅇㅣㅇㅁㅏㄴ
yevgeni	ㅇㅖㅂㅡㄱㅔㄴㅣ
ono	ㅇㅗㄴㅗ
peralta	ㅍㅔㄹㅏㄹㅌㅏ
adriano	ㅇㅏㄷㅡㄹㅣㅇㅏㄴㅜ
bunin	ㅂㅜㄴㅣㄴ
massimo	ㅁㅏㅅㅣㅁㅗ
kofi	ㅋㅗㅍㅣ
radomir	ㄹㅏㄷㅗㅁㅣㄹㅡ
cunningham	ㅋㅓㄴㅣㅇㅇㅓㅁ
logan	ㄹㅗㄱㅓㄴ
redmond	ㄹㅔㄷㅡㅁㅓㄴㄷㅡ
ying	ㅇㅣㅇ
mckenzie	ㅁㅐㅋㅔㄴㅈㅣ
yaya	ㅇㅑㅇㅑ
liam	ㄹㅣㅇㅓㅁ
ong	ㅇㅗㅇ
janet	ㅈㅐㄴㅣㅅ
rooney	ㄹㅜㄴㅣ
feist	ㅍㅏㅇㅣㅅㅡㅌㅡ
schlegel	ㅅㅠㄹㄹㅔㄱㅔㄹ
stephen	ㅅㅡㅌㅣㅂㅡㄴ
dickey	ㄷㅣㅋㅣ
scotty	ㅅㅡㅋㅗㅌㅣ
kliment	ㅋㅡㄹㄹㅣㅁㅔㄴㅌㅡ
lev	ㄹㅔㅍㅡ
vicente	ㅂㅣㅅㅔㄴㅌㅔ
juliusz	ㅇㅠㄹㄹㅣㅇㅜㅅㅣ
dominik	ㄷㅗㅁㅣㄴㅣㅋㅡ
marine	ㅁㅏㄹㅣㄴ
herman	ㅎㅓㅁㅓㄴ
whedon	ㅎㅟㄷㅓㄴ
lou	ㄹㅜ
haim	ㅎㅏㅇㅣㅁ
balaban	ㅂㅏㄹㄹㅏㅂㅏㄴ
kalina	ㅋㅏㄹㄹㅣㄴㅏ
brahim	ㅂㅡㄹㅏㅎㅣㅁ
pierce	ㅍㅣㅇㅓㅅㅡ
nelson	ㄴㅔㄹㅅㅡㄴ
igor	ㅇㅣㄱㅗㄹㅡ
mccreary	ㅁㅐㅋㅡㄹㅣㄹㅣ
natacha	ㄴㅏㅌㅏㅅㅑ
theresa	ㅌㅔㄹㅔㅅㅏ
allyson	ㅇㅐㄹㄹㅣㅅㅡㄴ
ed	ㅇㅔㄷㅡ
nawaz	ㄴㅏㅇㅘㅈㅡ
buckley	ㅂㅓㅋㅡㄹㄹㅣ
vilhelm	ㅂㅣㄹㅎㅔㄹㄹㅡㅁ
b	ㅂㅣ
leo	ㄹㅔㅇㅗ
drucker	ㄷㅡㄹㅟㅋㅔㄹㅡ
murilo	ㅁㅜㄹㅣㄹㄹㅜ
milton	ㅁㅣㄹㅌㅓㄴ
nilsson	ㄴㅣㄹㅅㅗㄴ
darrow	ㄷㅐㄹㅗ
adolphe	ㅇㅏㄷㅗㄹㅍㅡ
mccarthy	ㅁㅐㅋㅏㅅㅣ
zlatan	ㅈㅡㄹㄹㅏㅌㅏㄴ
wangchuck	ㅇㅘㅇㅊㅜㄱ
roger	ㄹㅗㅈㅓ
paulina	ㅍㅏㅇㅜㄹㄹㅣㄴㅏ
milgram	ㅁㅣㄹㄱㅡㄹㅐㅁ
caleb	ㅋㅔㅇㅣㄹㄹㅓㅂ
bellamy	ㅂㅔㄹㄹㅓㅁㅣ
alfredo	ㅇㅏㄹㅍㅡㄹㅔㄷㅗ
landau	ㄹㅐㄴㄷㅗ
egan	ㅇㅣㄱㅓㄴ
hartmann	ㅎㅏㄹㅡㅌㅡㅁㅏㄴ
sahar	ㅅㅏㅎㅏㄹㅡ
titus	ㅌㅣㅌㅜㅅㅡ
andres	ㅇㅏㄴㄷㅡㄹㅔㅅㅡ
aldo	ㅇㅏㄹㄷㅗ
mohammad	ㅁㅗㅎㅏㅁㅏㄷㅡ
dewitt	ㄷㅣㅇㅟㅅ
powers	ㅍㅏㅇㅝㅅㅡ
huygens	ㅎㅏㅇㅟㅎㅓㄴㅅㅡ
toledo	ㅌㅗㄹㄹㅔㄷㅗ
collins	ㅋㅗㄹㄹㅣㄴㅅㅡ
toussaint	ㅌㅜㅅㅐㅇ
gao	ㅂㅜㄱㅈㅔ
friedman	ㅍㅡㄹㅣㄷㅡㅁㅓㄴ
andrija	ㅇㅏㄴㄷㅡㄹㅣㅇㅑ
porcaro	ㅍㅗㅋㅏㄹㅗ
nevin	ㄴㅔㅂㅣㄴ
kapsis	ㅋㅏㅍㅡㅅㅣㅅㅡ
ferrer	ㅍㅔㄹㅔㄹㅡ
lillian	ㄹㅣㄹㄹㅣㅇㅓㄴ
gaspard	ㄱㅏㅅㅡㅍㅏㄹㅡ
norbert	ㄴㅗㄹㅡㅂㅔㄹㅡㅌㅡ
kiyomasa	ㄱㅣㅇㅛㅁㅏㅅㅏ
branko	ㅂㅡㄹㅏㅇㅋㅗ
holland	ㅎㅗㄹㄹㅐㄴㄷㅡ
vela	ㅂㅔㄹㄹㅏ
morton	ㅁㅗㅌㅓㄴ
elijah	ㅇㅣㄹㄹㅏㅇㅣㅈㅓ
leko	ㄹㅔㅋㅗ
vida	ㅂㅣㄷㅏ
behn	ㅂㅔㄴ
schreyer	ㅅㅠㄹㅏㅇㅣㅇㅓ
hilary	ㅎㅣㄹㄹㅓㄹㅣ
newton	ㄴㅠㅌㅓㄴ
butterfield	ㅂㅓㅌㅓㅍㅣㄹㄷㅡ
riedel	ㄹㅣㄷㅔㄹ
randall	ㄹㅐㄴㄷㅡㄹ
patrik	ㅍㅏㅌㅡㄹㅣㅋㅡ
wojciech	ㅂㅗㅇㅣㅊㅣㅇㅔㅎㅡ
huang	ㅎㅘㅇ
macarena	ㅁㅏㅋㅏㄹㅔㄴㅏ
guterres	ㄱㅜㅌㅔㅎㅡㅅㅡ
faria	ㅍㅏㄹㅣㅇㅏ
pemberton	ㅍㅔㅁㅂㅓㅌㅓㄴ
rabiu	ㄹㅏㅂㅣㅇㅜ
masterson	ㅁㅏㅅㅡㅌㅓㅅㅡㄴ
kayla	ㅋㅔㅇㅣㄹㄹㅏ
yogi	ㅇㅛㄱㅣ
yakin	ㅇㅑㅋㅣㄴ
sultan	ㅅㅜㄹㅌㅏㄴ
frida	ㅍㅡㄹㅣㄷㅏ
picasso	ㅍㅣㅋㅏㅅㅗ
kari	ㅋㅐㄹㅣ
strickland	ㅅㅡㅌㅡㄹㅣㅋㅡㄹㄹㅐㄴㄷㅡ
kieren	ㅋㅣㄹㅓㄴ
haushofer	ㅎㅏㅇㅜㅅㅡㅎㅗㅍㅓ
sweet	ㅅㅡㅇㅟㅌㅡ
alberti	ㅇㅏㄹㅂㅔㄹㅡㅌㅣ
cyril	ㅅㅣㄹㅣㄹ
jansen	ㅇㅑㄴㅅㅔㄴ
ewald	ㅇㅔㅂㅏㄹㅌㅡ
wynne	ㅇㅟㄴ
mannheim	ㅁㅏㄴㅎㅏㅇㅣㅁ
mette	ㅁㅔㅌㅔ
borja	ㅂㅗㄹㅡㅎㅏ
dizzy	ㄷㅣㅈㅣ
hakim	ㅎㅏㅋㅣㅁ
pompeius	ㅍㅗㅁㅍㅔㅇㅣㅇㅜㅅㅡ
marcelino	ㅁㅏㄹㅡㅅㅔㄹㄹㅣㄴㅗ
clarkson	ㅋㅡㄹㄹㅏㅋㅡㅅㅡㄴ
primo	ㅍㅡㄹㅣㅁㅗ
riera	ㄹㅣㅇㅔㄹㅏ
sammy	ㅅㅐㅁㅣ
bjarni	ㅂㅣㅇㅏㄹㅡㄷㅡㄴㅣ
farmiga	ㅍㅏㅁㅣㄱㅏ
clary	ㅋㅡㄹㄹㅏㄹㅣ
rahm	ㄹㅏㅁ
klaus	ㅋㅡㄹㄹㅏㅇㅜㅅㅡ
tsarnaev	ㅊㅏㄹㅡㄴㅏㅇㅖㅍㅡ
perrin	ㅍㅔㄹㅐㅇ
cassandra	ㅋㅓㅅㅐㄴㄷㅡㄹㅏ
lutz	ㄹㅜㅊㅡ
clarke	ㅋㅡㄹㄹㅏㅋㅡ
galina	ㄱㅏㄹㄹㅣㄴㅏ
di	ㄷㅣ
nearing	ㄴㅣㅇㅓㄹㅣㅇ
alyson	ㅇㅐㄹㄹㅣㅅㅡㄴ
sturm	ㅅㅡㅌㅟㄹㅡㅁ
hosseini	ㅎㅗㅅㅔㅇㅣㄴㅣ
ogata	ㅇㅗㄱㅏㅌㅏ
yara	ㅇㅑㄹㅏ
varela	ㅂㅏㄹㅔㄹㄹㅏ
britt	ㅂㅡㄹㅣㅅ
kruger	ㅋㅡㄹㅜㄱㅓ
melanie	ㅁㅔㄹㄹㅓㄴㅣ
phan	ㅍㅏㄴ
pat	ㅍㅐㅅ
christiane	ㅋㅡㄹㅣㅅㅡㅌㅣㅇㅏㄴㅔ
rosati	ㄹㅗㅅㅏㅌㅣ
hirsch	ㅎㅓㅅㅣ
manabe	ㅁㅏㄴㅏㅂㅔ
jenna	ㅈㅔㄴㅏ
per	ㅍㅔㄹㅡ
tobias	ㅌㅗㅂㅣㅇㅏㅅㅡ
stapleton	ㅅㅡㅌㅔㅇㅣㅍㅡㄹㅌㅓㄴ
hardy	ㅎㅏㄷㅣ
wiese	ㅂㅣㅈㅔ
cole	ㅋㅗㄹ
uribe	ㅇㅜㄹㅣㅂㅔ
shapur	ㅅㅑㅍㅜㄹㅡ
broca	ㅂㅡㄹㅗㅋㅏ
nobutsuna	ㄴㅗㅂㅜㅆㅡㄴㅏ
rowan	ㄹㅗㅇㅘㄴ
edie	ㅇㅔㄷㅣ
denisov	ㄷㅔㄴㅣㅅㅗㅍㅡ
olivier	ㅇㅗㄹㄹㅣㅂㅣㅇㅔ
driver	ㄷㅡㄹㅏㅇㅣㅂㅓ
heart	ㅎㅏㅌㅡ
frey	ㅍㅡㄹㅔㅇㅣ
evandro	ㅇㅔㅂㅏㄴㄷㅡㄹㅜ
hodgson	ㅎㅗㅈㅣㅅㅡㄴ
marks	ㅁㅏㅋㅡㅅㅡ
moyer	ㅁㅗㅇㅣㅇㅓ
nixon	ㄴㅣㄱㅅㅡㄴ
maximilian	ㅁㅏㄱㅅㅣㅁㅣㄹㄹㅣㅇㅏㄴ
linda	ㄹㅣㄴㄷㅏ
samandi	ㅅㅏㅁㅏㄴㄷㅣ
levinson	ㄹㅔㅂㅣㄴㅅㅡㄴ
dries	ㄷㅡㄹㅣㅅㅡ
vaughan	ㅂㅗㄴ
milla	ㅁㅣㄹㄹㅏ
berry	ㅂㅔㄹㅣ
mykola	ㅁㅣㅋㅗㄹㄹㅏ
yunus	ㅇㅠㄴㅜㅅㅡ
hoffman	ㅎㅗㅍㅡㅁㅓㄴ
beauharnais	ㅂㅗㅇㅏㄹㅡㄴㅔ
nadezhda	ㄴㅏㄷㅔㅈㅡㄷㅏ
grady	ㄱㅡㄹㅐㄷㅣ
adrian	ㅇㅔㅇㅣㄷㅡㄹㅣㅇㅓㄴ
hamid	ㅎㅏㅁㅣㄷㅡ
parra	ㅍㅏㄹㅏ
bayan	ㅂㅏㅇㅑㄴ
massimiliano	ㅁㅏㅅㅣㅁㅣㄹㄹㅣㅇㅏㄴㅗ
malaika	ㅁㅏㄹㄹㅏㅇㅣㅋㅏ
lis	ㄹㅣㅅㅡ
gustavo	ㄱㅜㅅㅡㅌㅏㅂㅗ
tsutomu	ㅅㅏㅌㅗ
vasco	ㅂㅏㅅㅡㅋㅗ
mcgregor	ㅁㅐㄱㄱㅡㄹㅔㄱㅓ
maura	ㅁㅏㅇㅜㄹㅏ
masamoto	ㅁㅏㅅㅏㅁㅗㅌㅗ
suzuki	ㅅㅡㅈㅡㅋㅣ
pietro	ㅍㅣㅇㅔㅌㅡㄹㅗ
dan	ㄷㅐㄴ
donnelly	ㄷㅗㄴㅓㄹㄹㅣ
sui	ㅅㅜㅇㅣ
raman	ㄹㅏㅁㅏㄴ
jardine	ㅈㅏㄷㅣㄴ
stern	ㅅㅡㅌㅓㄴ
rolando	ㄹㅗㄹㄹㅏㄴㄷㅗ
petru	ㅍㅔㅌㅡㄹㅜ
renzo	ㄹㅔㄴㅈㅗ
leonidas	ㄹㅔㅇㅗㄴㅣㄷㅏㅅㅡ
dieter	ㄷㅣㅌㅓ
ellen	ㅇㅔㄹㄹㅓㄴ
rahul	ㄹㅏㅎㅜㄹ
miner	ㅁㅏㅇㅣㄴㅓ
ritter	ㄹㅣㅌㅓ
valla	ㅂㅏㄹㄹㅏ
schwegler	ㅅㅠㅂㅔㄱㅡㄹㄹㅓ
sheridan	ㅅㅖㄹㅣㄷㅓㄴ
toda	ㄷㅗㄷㅏ
peck	ㅍㅔㄱ
shevchenko	ㅅㅖㅂㅊㅔㄴㅋㅗ
tony	ㅌㅗㄴㅣ
thurman	ㅅㅓㅁㅓㄴ
robards	ㄹㅗㅂㅓㅈㅡ
ralph	ㄹㅐㄹㅍㅡ
matsuura	ㅇㅏㅆㅡㅅㅣ
roberto	ㄹㅗㅂㅔㄹㅡㅌㅗ
arslan	ㅇㅏㄹㅡㅅㅡㄹㄹㅏㄴ
humphries	ㅎㅓㅁㅍㅡㄹㅣㅅㅡ
vladas	ㅂㅡㄹㄹㅏㄷㅏㅅㅡ
toni	ㅌㅗㄴㅣ
willis	ㅇㅟㄹㄹㅣㅅㅡ
strom	ㅅㅡㅌㅡㄹㅗㅁ
kid	ㅋㅣㄷㅡ
yamaguchi	ㅇㅣㅊㅣㄹㅗ
gil	ㅎㅣㄹ
curtis	ㅋㅓㅌㅣㅅㅡ
artyom	ㅇㅏㄹㅡㅌㅛㅁ
barron	ㅂㅐㄹㅓㄴ
lennox	ㄹㅔㄴㅗㄱㅅㅡ
hunt	ㅎㅓㄴㅌㅡ
dodson	ㄷㅗㄷㅡㅅㅡㄴ
chauvin	ㅅㅛㅂㅐㅇ
rusev	ㄹㅜㅅㅔㅍㅡ
stark	ㅅㅠㅌㅏㄹㅡㅋㅡ
kirchhoff	ㅋㅣㄹㅡㅎㅣㅎㅗㅍㅡ
belcher	ㅂㅔㄹㅊㅓ
dimitrios	ㄷㅣㅁㅣㅌㅡㄹㅣㅇㅗㅅㅡ
petrov	ㅍㅔㅌㅡㄹㅗㅍㅡ
murad	ㅁㅜㄹㅏㅌㅡ
chamberlain	ㅊㅔㅇㅣㅁㅂㅓㄹㄹㅣㄴ
gabor	ㄱㅏㅂㅗㄹㅡ
rhys	ㄹㅣㅅㅡ
masaaki	ㅁㅗㄹㅣ
thutmose	ㅌㅜㅌㅡㅁㅗㅅㅔ
prakash	ㅍㅡㄹㅏㅋㅏㅅㅣ
coco	ㅋㅗㅋㅗ
gasol	ㄱㅏㅅㅗㄹ
joe	ㅈㅗ
mclaren	ㅁㅐㅋㅡㄹㄹㅐㄹㅓㄴ
sandra	ㅅㅏㄴㄷㅡㄹㅏ
aoyama	ㅇㅏㅇㅗㅇㅑㅁㅏ
childeric	ㅎㅣㄹㄷㅔㄹㅣㅎㅣ
venizelos	ㅂㅔㄴㅣㅈㅔㄹㄹㅗㅅㅡ
arima	ㅇㅏㄹㅣㅁㅏ
hanna	ㅎㅏㄴㄴㅏ
coyle	ㅋㅗㅇㅣㄹ
goldie	ㄱㅗㄹㄷㅣ
weinstein	ㅇㅞㅇㅣㄴㅅㅡㅌㅏㅇㅣㄴ
alcides	ㅇㅏㄹㅅㅣㄷㅔㅅㅡ
valeria	ㅂㅏㄹㄹㅔㄹㅣㅇㅏ
eugenia	ㅇㅔㅇㅜㅎㅔㄴㅣㅇㅏ
sunday	ㅅㅓㄴㄷㅔㅇㅣ
isao	ㅅㅏㅅㅏㅋㅣ
ibrahim	ㅇㅣㅂㅡㄹㅏㅎㅣㅁ
calvin	ㅋㅐㄹㅂㅣㄴ
stu	ㅅㅡㅌㅜ
seal	ㅅㅣㄹ
urs	ㅇㅜㄹㅡㅅㅡ
graziano	ㄱㅡㄹㅏㅈㅣㅇㅏㄴㅗ
call	ㅋㅗㄹ
singh	ㅅㅣㅇ
dixie	ㄷㅣㄱㅅㅣ
selma	ㅅㅔㄹㅁㅏ
buzek	ㅂㅜㅈㅔㅋㅡ
eriksson	ㅇㅔㄹㅣㄱㅅㅗㄴ
jai	ㅈㅔㅇㅣ
missy	ㅁㅣㅅㅣ
zoega	ㅈㅗㅇㅔㄱㅏ
potts	ㅍㅗㅊㅡ
takanori	ㄷㅏㅋㅏㄴㅗㄹㅣ
nemanja	ㄴㅔㅁㅏㄴㅑ
archie	ㅇㅏㅊㅣ
cori	ㅋㅗㄹㅣ
osbourne	ㅇㅗㅈㅡㅂㅓㄴ
mae	ㅁㅔㅇㅣ
yahya	ㅇㅑㅎㅣㅇㅏ
simon	ㅅㅏㅇㅣㅁㅓㄴ
guggenheim	ㄱㅜㄱㅔㄴㅎㅏㅇㅣㅁ
kozlov	ㅋㅗㅈㅡㄹㄹㅗㅍㅡ
tomislav	ㅌㅗㅁㅣㅅㅡㄹㄹㅏㅂㅡ
chandra	ㅊㅏㄴㄷㅡㄹㅏ
korine	ㅋㅗㄹㅣㄴ
kilby	ㅋㅣㄹㅂㅣ
tucci	ㅌㅜㅊㅣ
zbigniew	ㅈㅡㅂㅣㄱㅡㄴㅣㅇㅔㅍㅡ
eve	ㅇㅣㅂㅡ
alan	ㅇㅐㄹㄹㅓㄴ
floriano	ㅍㅡㄹㄹㅗㄹㅣㅇㅏㄴㅜ
hardwicke	ㅎㅏㄷㅡㅇㅟㄱ
nakajima	ㅅㅏㅋㅣ
bach	ㅂㅏㅎㅡ
neves	ㄴㅔㅂㅔㅅㅡ
sophia	ㅅㅗㅍㅣㅇㅏ
francisco	ㅍㅡㄹㅏㄴㅅㅣㅅㅡㅋㅗ
andoni	ㅇㅏㄴㄷㅗㄴㅣ
oh	ㅇㅗ
danielle	ㄷㅐㄴㅣㅇㅔㄹ
neal	ㄴㅣㄹ
ola	ㅇㅗㄹㄹㅏ
takis	ㅌㅏㅋㅣㅅㅡ
paulinho	ㅍㅏㅇㅜㄹㄹㅣㄴㅠ
segal	ㅅㅣㄱㅓㄹ
woodley	ㅇㅜㄷㅡㄹㄹㅣ
stacey	ㅅㅡㅌㅔㅇㅣㅅㅣ
aggarwal	ㅇㅏㄱㅏㄹㅡㅇㅘㄹ
angelos	ㅇㅏㅇㄱㅔㄹㄹㅗㅅㅡ
dora	ㄷㅗㄹㅏ
luke	ㄹㅜㅋㅡ
livio	ㄹㅣㅂㅣㅇㅗ
lindblad	ㄹㅣㄴㄷㅡㅂㅡㄹㄹㅏㄷㅡ
sparks	ㅅㅡㅍㅏㅋㅡㅅㅡ
jensen	ㅇㅖㄴㅅㅔㄴ
gigi	ㅈㅣㅈㅣ
chong	ㅊㅗㅇ
vainio	ㅂㅏㅇㅣㄴㅣㅇㅗ
katsuhiro	ㅅㅡㅈㅡㅋㅣ
hanke	ㅎㅏㅇㅋㅔ
rita	ㄹㅣㅌㅏ
beanie	ㅂㅣㄴㅣ
bessie	ㅂㅔㅅㅣ
motta	ㅁㅗㅌㅏ
karin	ㅋㅏㄹㅣㄴ
timoshenko	ㅌㅣㅁㅗㅅㅖㄴㅋㅗ
aditi	ㅇㅏㄷㅣㅌㅣ
algimantas	ㅇㅏㄹㄱㅣㅁㅏㄴㅌㅏㅅㅡ
jacobus	ㅇㅑㅋㅗㅂㅜㅅㅡ
mcarthur	ㅁㅐㄱㅇㅏㄷㅓ
krause	ㅋㅡㄹㅏㅇㅜㅅㅡ
hague	ㅎㅔㅇㅣㄱㅡ
marian	ㅁㅏㄹㅣㅇㅏㄴ
luisa	ㄹㅜㅇㅣㅅㅏ
harry	ㅎㅐㄹㅣ
julia	ㅈㅜㄹㄹㅣㅇㅏ
mieszko	ㅁㅣㅇㅔㅅㅠㅋㅗ
szabo	ㅅㅏㅂㅗ
winter	ㅇㅟㄴㅌㅓ
plummer	ㅍㅡㄹㄹㅓㅁㅓ
celia	ㅅㅔㄹㄹㅣㅇㅏ
springfield	ㅅㅡㅍㅡㄹㅣㅇㅍㅣㄹㄷㅡ
broderick	ㅂㅡㄹㅗㄷㅓㄹㅣㄱ
charles	ㅊㅏㄹㅅㅡ
jacob	ㅈㅔㅇㅣㅋㅓㅂ
ryle	ㄹㅏㅇㅣㄹ
michele	ㅁㅣㅋㅔㄹㄹㅔ
kulikov	ㅋㅜㄹㄹㅣㅋㅗㅍㅡ
hofmann	ㅎㅗㅍㅡㅁㅏㄴ
alpha	ㅇㅏㄹㅍㅏ
masayoshi	ㅁㅏㅅㅏㅇㅛㅅㅣ
fay	ㅍㅔㅇㅣ
goldman	ㄱㅗㄹㄷㅡㅁㅓㄴ
kenneth	ㅋㅔㄴㅔㅅㅡ
tardelli	ㅌㅏㄹㅡㄷㅔㄹㄹㅣ
brent	ㅂㅡㄹㅔㄴㅌㅡ
tessa	ㅌㅔㅅㅏ
burger	ㅂㅓㄱㅓ
sascha	ㅅㅏㅅㅑ
mamo	ㅁㅏㅁㅗ
anatoly	ㅇㅏㄴㅏㅌㅗㄹㄹㅣ
katrin	ㅋㅏㅌㅡㄹㅣㄴ
bruni	ㅂㅡㄹㅜㄴㅣ
jerins	ㅈㅔㄹㅣㄴㅅㅡ
anier	ㅇㅏㄴㅣㅇㅔㄹㅡ
constantius	ㅋㅗㄴㅅㅡㅌㅏㄴㅌㅣㅇㅜㅅㅡ
carnot	ㅋㅏㄹㅡㄴㅗ
marlon	ㅁㅏㄹㄹㅓㄴ
yulia	ㅇㅠㄹㄹㅣㅇㅑ
constant	ㅋㅗㅇㅅㅡㅌㅏㅇ
roe	ㄹㅗ
crocker	ㅋㅡㄹㅗㅋㅓ
dickinson	ㄷㅣㅋㅣㄴㅅㅡㄴ
marianne	ㅁㅏㄹㅣㅇㅏㄴ
serena	ㅅㅔㄹㅣㄴㅏ
foster	ㅍㅗㅅㅡㅌㅓ
alex	ㅇㅐㄹㄹㅣㄱㅅㅡ
hedison	ㅎㅔㄷㅣㅅㅡㄴ
rhonda	ㄹㅗㄴㄷㅏ
magno	ㅁㅏㄱㅡㄴㅜ
meyer	ㅁㅏㅇㅣㅇㅓ
oda	ㅇㅗㄷㅏ
sturgeon	ㅅㅡㅌㅓㅈㅓㄴ
anouk	ㅇㅏㄴㅜㅋㅡ
feitosa	ㅍㅔㅇㅣㅌㅗㅈㅏ
kroeger	ㅋㅡㄹㅗㄱㅓ
nobutoshi	ㄴㅗㅂㅜㅌㅗㅅㅣ
mane	ㅁㅔㅇㅣㄴ
kellogg	ㅋㅔㄹㄹㅗㄱㅡ
hasan	ㅎㅏㅅㅏㄴ
tahar	ㅌㅏㅎㅏㄹㅡ
gisela	ㄱㅣㅈㅔㄹㄹㅏ
pinckney	ㅍㅣㅇㅋㅡㄴㅣ
stan	ㅅㅡㅌㅐㄴ
michelangelo	ㅁㅣㅋㅔㄹㄹㅏㄴㅈㅔㄹㄹㅗ
pucci	ㅍㅜㅊㅣ
randleman	ㄹㅐㄴㄷㅡㄹㅁㅓㄴ
lindahl	ㄹㅣㄴㄷㅏㄹ
dellinger	ㄷㅔㄹㄹㅣㄴㅈㅓ
morosini	ㅁㅗㄹㅗㅅㅣㄴㅣ
bello	ㅂㅔㄹㄹㅗ
renu	ㄹㅔㄴㅜ
keeler	ㅋㅣㄹㄹㅓ
baltasar	ㅂㅏㄹㅌㅏㅅㅏㄹㅡ
basile	ㅂㅏㅅㅣㄹㄹㅔ
sereno	ㅅㅔㄹㅔㄴㅗ
rush	ㄹㅓㅅㅣ
hume	ㅎㅠㅁ
toshinaga	ㄷㅗㅅㅣㄴㅏㄱㅏ
lina	ㄹㅣㄴㅏ
stockwell	ㅅㅡㅌㅗㄱㅇㅞㄹ
diana	ㄷㅏㅇㅣㅇㅐㄴㅏ
edvard	ㅇㅔㄷㅡㅂㅏㄹㅡㄷㅡ
arianna	ㅇㅏㄹㅣㅇㅏㄴㄴㅏ
kyra	ㅋㅣㄹㅏ
sato	ㅇㅛㅅㅣㄴㅗㄹㅣ
gomes	ㄱㅗㅁㅔㅅㅡ
volodymyr	ㅂㅗㄹㄹㅗㄷㅣㅁㅣㄹㅡ
kerzhakov	ㅋㅔㄹㅡㅈㅏㅋㅗㅍㅡ
lowell	ㄹㅗㅇㅞㄹ
leopold	ㄹㅔㅇㅗㅍㅗㄹㅌㅡ
mehmet	ㅁㅔㅎㅡㅁㅔㅌㅡ
roux	ㄹㅜ
moise	ㅁㅗㅇㅣㅅㅡ
fredric	ㅍㅡㄹㅔㄷㅡㄹㅣㄱ
barrera	ㅂㅏㄹㅔㄹㅏ
jericho	ㅈㅔㄹㅣㅋㅗ
radoslav	ㄹㅏㄷㅗㅅㅡㄹㄹㅏㅍㅡ
albright	ㅇㅗㄹㅂㅡㄹㅏㅇㅣㅌㅡ
fabian	ㅍㅏㅂㅣㅇㅏㄴ
sue	ㅅㅜ
mahamat	ㅁㅏㅎㅏㅁㅏㅌㅡ
itagaki	ㅇㅣㅌㅏㄱㅏㅋㅣ
sin	ㅅㅣㄴ
standish	ㅅㅡㅌㅐㄴㄷㅣㅅㅣ
omara	ㅇㅗㅁㅏㄹㅏ
martin	ㅁㅏㅌㅣㄴ
aziz	ㅇㅏㅈㅣㅈㅡ
elle	ㅇㅔㄹ
khanna	ㅋㅏㄴㄴㅏ
love	ㄹㅓㅂㅡ
parry	ㅍㅐㄹㅣ
ciprian	ㅊㅣㅍㅡㄹㅣㅇㅏㄴ
monaghan	ㅁㅗㄴㅏㅎㅏㄴ
gun	ㄱㅓㄴ
masamune	ㅁㅏㅅㅏㅁㅜㄴㅔ
ismailov	ㅇㅣㅅㅡㅁㅏㅇㅣㄹㄹㅗㅍㅡ
adderley	ㅇㅐㄷㅓㄹㄹㅣ
entwistle	ㅇㅔㄴㅌㅡㅇㅟㅅㅡㄹ
hummel	ㅎㅜㅁㅁㅔㄹ
amparo	ㅇㅏㅁㅍㅏㄹㅗ
childe	ㅊㅏㅇㅣㄹㄷㅡ
kuti	ㅋㅜㅌㅣ
apatow	ㅇㅐㅍㅓㅌㅗ
nikki	ㄴㅣㅋㅣ
dev	ㄷㅔㅂㅡ
luongo	ㄹㅜㅇㅗㅇㄱㅗ
lyn	ㄹㅣㄴ
butt	ㅂㅓㅌㅡ
sharif	ㅅㅑㄹㅣㅍㅡ
reiner	ㄹㅏㅇㅣㄴㅓ
yegor	ㅇㅖㄱㅗㄹㅡ
lilli	ㄹㅣㄹㄹㅣ
mccullough	ㅁㅐㅋㅓㄹㄹㅗ
micaela	ㅁㅣㅋㅏㅇㅔㄹㄹㅏ
petri	ㅍㅔㅌㅡㄹㅣ
borgia	ㅂㅗㄹㅡㅈㅏ
dandolo	ㄷㅏㄴㄷㅗㄹㄹㅗ
rebekah	ㄹㅣㅂㅔㅋㅏ
art	ㅇㅏㅌㅡ
carles	ㅋㅏㄹㅡㄹㄹㅔㅅㅡ
bear	ㅂㅔㅇㅓ
bonaventura	ㅂㅗㄴㅏㅂㅔㄴㅌㅜㄹㅏ
nobuaki	ㄴㅗㅂㅜㅇㅏㅋㅣ
skyler	ㅅㅡㅋㅏㅇㅣㄹㄹㅓ
miranda	ㅁㅣㄹㅏㄴㄷㅏ
kane	ㅋㅔㅇㅣㄴ
macron	ㅁㅏㅋㅡㄹㅗㅇ
oleg	ㅇㅗㄹㄹㅔㅋㅡ
elm	ㅇㅔㄹㄹㅡㅁ
rhodes	ㄹㅗㅈㅡ
jara	ㅎㅏㄹㅏ
cain	ㅋㅔㅇㅣㄴ
nikos	ㄴㅣㅋㅗㅅㅡ
rhea	ㄹㅔㅇㅏ
rusty	ㄹㅓㅅㅡㅌㅣ
marchese	ㅁㅏㄹㅡㅋㅔㅅㅔ
frederico	ㅍㅡㄹㅔㄷㅔㄹㅣㅋㅜ
gavin	ㄱㅐㅂㅣㄴ
matos	ㅁㅏㅌㅜㅅㅡ
devin	ㄷㅔㅂㅣㄴ
abu	ㅇㅏㅂㅜ
rie	ㄹㅣㅇㅔ
salam	ㅅㅏㄹㄹㅏㅁ
aksel	ㅇㅏㄱㅅㅔㄹ
cort	ㅋㅗㅌㅡ
mott	ㅁㅗㅌㅡ
schiff	ㅅㅣㅍㅡ
gall	ㄱㅏㄹ
kazys	ㅋㅏㅈㅣㅅㅡ
murillo	ㅁㅜㄹㅣㅇㅛ
silke	ㅈㅣㄹㅋㅔ
bruna	ㅂㅡㄹㅜㄴㅏ
sokolov	ㅅㅗㅋㅗㄹㄹㅗㅍㅡ
navi	ㄴㅏㅂㅣ
shin	ㅅㅣㄴ
waleed	ㅇㅘㄹㄹㅣㄷㅡ
johan	ㅇㅛㅎㅏㄴ
alyn	ㅇㅐㄹㄹㅣㄴ
dior	ㄷㅣㅇㅗㄹㅡ
azuma	ㅎㅣㄹㅗㅋㅣ
masuko	ㅇㅛㅅㅣㅎㅣㄹㅗ
mandy	ㅁㅐㄴㄷㅣ
yoshikata	ㅇㅛㅅㅣㅋㅏㅌㅏ
alidosi	ㅇㅏㄹㄹㅣㄷㅗㅅㅣ
diego	ㄷㅣㅇㅔㄱㅗ
bourgeois	ㅂㅜㄹㅡㅈㅜㅇㅏ
schumann	ㅅㅠㅁㅏㄴ
zane	ㅈㅔㅇㅣㄴ
timo	ㅌㅣㅁㅗ
treat	ㅌㅡㄹㅣㅌㅡ
brenner	ㅂㅡㄹㅔㄴㅓ
plaza	ㅍㅡㄹㄹㅏㅈㅏ
shetty	ㅅㅖㅌㅣ
dorji	ㄷㅗㄹㅡㅈㅣ
norinaga	ㄴㅗㄹㅣㄴㅏㄱㅏ
oskar	ㅇㅗㅅㅡㅋㅏ
anupam	ㅇㅏㄴㅜㅍㅏㅁ
ernie	ㅇㅓㄴㅣ
milburn	ㅁㅣㄹㅂㅓㄴ
arquette	ㅇㅏㅋㅔㅅ
caruso	ㅋㅏㄹㅜㅅㅗ
dominic	ㄷㅗㅁㅣㄴㅣㄱ
stanford	ㅅㅡㅌㅐㄴㅍㅓㄷㅡ
kirsty	ㅋㅓㅅㅡㅌㅣ
pidgeon	ㅍㅣㅈㅓㄴ
sergi	ㅅㅔㄹㅡㅎㅣ
petit	ㅍㅡㅌㅣ
perkins	ㅍㅓㅋㅣㄴㅅㅡ
wilhelm	ㅂㅣㄹㅎㅔㄹㄹㅡㅁ
gabriela	ㄱㅏㅂㅡㄹㅣㅇㅔㄹㄹㅏ
pertti	ㅍㅔㄹㅡㅌㅣ
egli	ㅇㅔㄱㅡㄹㄹㅣ
martins	ㅁㅏㄹㅡㅌㅣㄴㅅㅡ
azita	ㅇㅏㅈㅣㅌㅏ
yevgeniya	ㅇㅖㅂㅡㄱㅔㄴㅣㅇㅑ
natali	ㄴㅏㅌㅏㄹㄹㅣ
hara	ㅎㅏㄹㅏ
mikoyan	ㅁㅣㅋㅗㅇㅑㄴ
cyrus	ㅅㅏㅇㅣㄹㅓㅅㅡ
milner	ㅁㅣㄹㄴㅓ
susanna	ㅅㅜㅈㅐㄴㅏ
mpenza	ㅇㅡㅁㅍㅔㄴㅈㅏ
forbes	ㅍㅗㅂㅡㅅㅡ
davi	ㄷㅏㅂㅣ
ezra	ㅇㅔㅈㅡㄹㅏ
christoph	ㅋㅡㄹㅣㅅㅡㅌㅗㅍㅡ
harsha	ㅎㅏㄹㅡㅅㅑ
nikolaidis	ㄴㅣㅋㅗㄹㄹㅏㅇㅣㄷㅣㅅㅡ
jennings	ㅈㅔㄴㅣㅇㅅㅡ
chopin	ㅅㅛㅍㅐㅇ
feigenbaum	ㅍㅏㅇㅣㄱㅔㄴㅂㅏㅇㅜㅁ
cam	ㅋㅐㅁ
safin	ㅅㅏㅍㅣㄴ
goldberg	ㄱㅗㄹㄷㅡㅂㅓㄱㅡ
tim	ㅌㅣㅁ
malik	ㅁㅏㄹㄹㅣㅋㅡ
willa	ㅇㅟㄹㄹㅏ
morel	ㅁㅗㄹㅔㄹ
clarence	ㅋㅡㄹㄹㅐㄹㅓㄴㅅㅡ
slutsky	ㅅㅡㄹㄹㅜㅊㅡㅋㅣ
mclaughlin	ㅁㅐㅋㅡㄹㄹㅗㅍㅡㄹㄹㅣㄴ
tennant	ㅌㅔㄴㅓㄴㅌㅡ
katrina	ㅋㅏㅌㅡㄹㅣㄴㅏ
washington	ㅇㅝㅅㅣㅇㅌㅓㄴ
spike	ㅅㅡㅍㅏㅇㅣㅋㅡ
leary	ㄹㅣㅇㅓㄹㅣ
coolidge	ㅋㅜㄹㄹㅣㅈㅣ
guevara	ㄱㅔㅂㅏㄹㅏ
linklater	ㄹㅣㅇㅋㅡㄹㄹㅔㅇㅣㅌㅓ
schuster	ㅅㅠㅅㅡㅌㅓ
andrade	ㅇㅏㄴㄷㅡㄹㅏㄷㅡ
heikki	ㅎㅔㅇㅣㅋㅣ
rafael	ㄹㅏㅍㅏㅇㅔㄹ
leni	ㄹㅔㄴㅣ
melling	ㅁㅔㄹㄹㅣㅇ
geena	ㅈㅣㄴㅏ
asamoah	ㅇㅏㅅㅏㅁㅗㅇㅏ
gore	ㄱㅗㅇㅓ
dukakis	ㄷㅠㅋㅏㅋㅣㅅㅡ
kubo	ㅇㅠㅇㅑ
aidan	ㅇㅔㅇㅣㄷㅏㄴ
levi	ㄹㅔㅂㅣ
edoardo	ㅇㅔㄷㅗㅇㅏㄹㅡㄷㅗ
juju	ㅈㅜㅈㅜ
judah	ㅈㅜㄷㅏ
buster	ㅂㅓㅅㅡㅌㅓ
denver	ㄷㅔㄴㅂㅓ
khan	ㅋㅏㄴ
judi	ㅈㅜㄷㅣ
fox	ㅍㅗㄱㅅㅡ
whitey	ㅎㅘㅇㅣㅌㅣ
petersen	ㅍㅔㅌㅔㄹㅡㅅㅔㄴ
peder	ㅍㅔㄷㅔㄹㅡ
clara	ㅋㅡㄹㄹㅏㄹㅏ
contreras	ㅋㅗㄴㅌㅡㄹㅔㄹㅏㅅㅡ
browning	ㅂㅡㄹㅏㅇㅜㄴㅣㅇ
collier	ㅋㅗㄹㄹㅣㅇㅓ
rennie	ㄹㅔㄴㅣ
corrigan	ㅋㅗㄹㅣㄱㅓㄴ
jasmine	ㅈㅐㅅㅡㅁㅣㄴ
prokhorov	ㅍㅡㄹㅗㅎㅗㄹㅗㅍㅡ
patrick	ㅍㅐㅌㅡㄹㅣㄱ
bogart	ㅂㅗㄱㅏㅌㅡ
dutton	ㄷㅓㅌㅡㄴ
sonali	ㅅㅗㄴㅏㄹㄹㅣ
ghosh	ㄱㅗㅅㅣ
joplin	ㅈㅗㅍㅡㄹㄹㅣㄴ
peacock	ㅍㅣㅋㅗㄱ
caro	ㅋㅏㄹㅗ
jobs	ㅈㅏㅂㅅㅡ
larry	ㄹㅐㄹㅣ
cartagena	ㅋㅏㄹㅡㅌㅏㅎㅔㄴㅏ
ferrara	ㅍㅔㄹㅏㄹㅏ
alison	ㅇㅐㄹㄹㅣㅅㅡㄴ
humphrey	ㅎㅓㅁㅍㅡㄹㅣ
benedetto	ㅂㅔㄴㅔㄷㅔㅌㅗ
giulia	ㅈㅜㄹㄹㅣㅇㅏ
oumar	ㅇㅜㅁㅏㄹㅡ
nakamura	ㄴㅏㅋㅏㅁㅜㄹㅏ
kemp	ㅋㅔㅁㅍㅡ
nate	ㄴㅔㅇㅣㅌㅡ
mircea	ㅁㅣㄹㅡㅊㅔㅇㅏ
masachika	ㅁㅏㅅㅏㅊㅣㅋㅏ
putnam	ㅍㅓㅌㅡㄴㅓㅁ
ishida	ㅇㅏㅇㅠㅁㅣ
knox	ㄴㅗㄱㅅㅡ
ettore	ㅇㅔㅌㅗㄹㅔ
suk	ㅅㅜㅋㅡ
downs	ㄷㅏㅇㅜㄴㅅㅡ
lundgren	ㄹㅜㄴㄷㅡㄱㅡㄹㅔㄴ
shalmaneser	ㅅㅑㄹㅁㅏㄴㅇㅔㅅㅔㄹㅡ
laudrup	ㄹㅏㅇㅜㄷㅡㄹㅜㅍㅡ
osmond	ㅇㅗㅈㅡㅁㅓㄴㄷㅡ
copeland	ㅋㅗㅍㅡㄹㄹㅐㄴㄷㅡ
judson	ㅈㅓㄷㅡㅅㅡㄴ
blad	ㅂㅡㄹㄹㅏㄷㅡ
murphy	ㅁㅓㅍㅣ
joubert	ㅈㅜㅂㅔㄹㅡ
cassini	ㅋㅏㅅㅣㄴㅣ
hiroko	ㅎㅣㄹㅗㅋㅗ
suzanne	ㅅㅜㅈㅏㄴ
katheryn	ㅋㅐㅅㅓㄹㅣㄴ
rock	ㄹㅗㄱ
blair	ㅂㅡㄹㄹㅔㅇㅓ
blind	ㅂㅡㄹㄹㅏㅇㅣㄴㄷㅡ
nobutaka	ㄴㅗㅂㅜㅌㅏㅋㅏ
crosby	ㅋㅡㄹㅗㅅㅡㅂㅣ
queiroz	ㅋㅔㅇㅣㄹㅜㅅㅡ
leslie	ㄹㅔㅅㅡㄹㄹㅣ
gibbs	ㄱㅣㅂㅡㅅㅡ
radhi	ㄹㅏㄷㅣ
shamil	ㅅㅑㅁㅣㄹ
nagasawa	ㄴㅏㅇㅗ
schenk	ㅅㅖㅇㅋㅡ
stephanie	ㅅㅡㅌㅔㅍㅓㄴㅣ
scholl	ㅅㅛㄹ
nobuyasu	ㄴㅗㅂㅜㅇㅑㅅㅡ
kretschmann	ㅋㅡㄹㅔㅊㅣㅁㅏㄴ
seymour	ㅅㅣㅁㅗㅇㅓ
angelo	ㅇㅏㄴㅈㅔㄹㄹㅗ
masaharu	ㅁㅏㅅㅏㅎㅏㄹㅜ
templeton	ㅌㅔㅁㅍㅡㄹㅌㅓㄴ
jaclyn	ㅈㅐㅋㅡㄹㄹㅣㄴ
rezaei	ㄹㅔㅈㅏㅇㅔㅇㅣ
bonnie	ㅂㅗㄴㅣ
tahan	ㅌㅏㅎㅐㄴ
colleen	ㅋㅗㄹㄹㅣㄴ
christian	ㅋㅡㄹㅣㅅㅡㅌㅣㅇㅏㄴ
danilo	ㄷㅏㄴㅣㄹㄹㅗ
lawler	ㄹㅗㄹㄹㅓ
heston	ㅎㅔㅅㅡㅌㅓㄴ
surratt	ㅅㅜㄹㅏㅅ
egor	ㅇㅔㄱㅗㄹㅡ
heinz	ㅎㅏㅇㅣㄴㅊㅡ
dix	ㄷㅣㄱㅅㅡ
azad	ㅇㅏㅈㅏㄷㅡ
quinton	ㅋㅟㄴㅌㅓㄴ
dos	ㄷㅜㅅㅡ
biwott	ㅂㅣㅇㅝㅌㅡ
camp	ㅋㅐㅁㅍㅡ
africanus	ㅇㅏㅍㅡㄹㅣㅋㅏㄴㅜㅅㅡ
ma	ㅁㅏ
neil	ㄴㅣㄹ
meek	ㅁㅣㄱ
paco	ㅍㅏㅋㅗ
zoe	ㅈㅗ
eschenbach	ㅇㅔㅅㅖㄴㅂㅏㅎㅡ
polly	ㅍㅗㄹㄹㅣ
machine	ㅁㅓㅅㅣㄴ
mcgrath	ㅁㅐㄱㄱㅡㄹㅐㅅㅡ
sanogo	ㅅㅏㄴㅗㄱㅗ
summers	ㅅㅓㅁㅓㅅㅡ
vilis	ㅂㅣㄹㄹㅣㅅㅡ
navarro	ㄴㅏㅂㅏㄹㅗ
mclean	ㅁㅐㅋㅡㄹㄹㅔㅇㅣㄴ
wagner	ㅇㅘㄱㅡㄴㅓ
burnet	ㅂㅓㄴㅔㅅ
hoshi	ㅎㅗㅅㅣ
pape	ㅍㅏㅍㅔ
shah	ㅅㅑ
serge	ㅅㅔㄹㅡㅈㅠ
tina	ㅌㅣㄴㅏ
malo	ㅁㅏㄹㄹㅗ
hale	ㅎㅔㅇㅣㄹ
greg	ㄱㅡㄹㅔㄱㅡ
ansari	ㅇㅏㄴㅅㅏㄹㅣ
nanna	ㄴㅏㄴㄴㅏ
faith	ㅍㅔㅇㅣㅅㅡ
race	ㄹㅔㅇㅣㅅㅡ
kuznetsov	ㅋㅜㅈㅡㄴㅔㅊㅗㅍㅡ
omar	ㅇㅗㅁㅏㄹㅡ
colton	ㅋㅗㄹㅌㅓㄴ
baron	ㅂㅐㄹㅓㄴ
nishi	ㄴㅣㅅㅣ
beigbeder	ㅂㅔㄱㅡㅂㅔㄷㅔ
tadatomo	ㄷㅏㄷㅏㅌㅗㅁㅗ
abdullah	ㅇㅏㅂㄷㅜㄹㄹㅏ
jose	ㅎㅗㅅㅔ
nagachika	ㄴㅏㄱㅏㅊㅣㅋㅏ
baumann	ㅂㅏㅇㅜㅁㅏㄴ
almeida	ㅇㅏㄹㅁㅔㅇㅣㄷㅏ
fernandes	ㅍㅔㄹㅡㄴㅏㄴㅈㅣㅅㅡ
bernie	ㅂㅓㄴㅣ
karla	ㅋㅏㄹㄹㅏ
takayuki	ㅅㅡㅈㅡㅋㅣ
rogers	ㄹㅗㅈㅓㅅㅡ
ronson	ㄹㅗㄴㅅㅡㄴ
trump	ㅌㅡㄹㅓㅁㅍㅡ
flannery	ㅍㅡㄹㄹㅐㄴㅓㄹㅣ
canio	ㅋㅏㄴㅣㅇㅗ
jagger	ㅈㅐㄱㅓ
meissner	ㅁㅏㅇㅣㅅㅡㄴㅓ
fuentes	ㅍㅜㅇㅔㄴㅌㅔㅅㅡ
benjamin	ㅂㅔㄴㅈㅓㅁㅣㄴ
okeeffe	ㅇㅗㅋㅣㅍㅡ
harden	ㅎㅏㄷㅡㄴ
freeman	ㅍㅡㄹㅣㅁㅓㄴ
euler	ㅇㅗㅇㅣㄹㄹㅓ
adama	ㅇㅏㄷㅏㅁㅏ
iwan	ㅇㅣㅇㅘㄴ
platt	ㅍㅡㄹㄹㅐㅅ
corey	ㅋㅗㄹㅣ
michiel	ㅁㅣㅎㅣㄹ
pino	ㅍㅣㄴㅗ
kaye	ㅋㅔㅇㅣ
quan	ㅋㅘㄴ
ranuccio	ㄹㅏㄴㅜㅊㅣㅇㅗ
way	ㅇㅞㅇㅣ
rahim	ㄹㅏㅎㅣㅁ
herbert	ㅎㅓㅂㅓㅌㅡ
coppola	ㅋㅗㅍㅗㄹㄹㅏ
westwood	ㅇㅞㅅㅡㅌㅡㅇㅜㄷㅡ
ito	ㅇㅣㅌㅗ
amandine	ㅇㅏㅁㅏㅇㄷㅣㄴ
morichika	ㅁㅗㄹㅣㅊㅣㅋㅏ
engineer	ㅇㅔㄴㅈㅣㄴㅣㅇㅓ
casper	ㅋㅐㅅㅡㅍㅓ
trish	ㅌㅡㄹㅣㅅㅣ
timberlake	ㅌㅣㅁㅂㅓㄹㅔㅇㅣㅋㅡ
simmons	ㅅㅣㅁㅓㄴㅅㅡ
colman	ㅋㅗㄹㅁㅓㄴ
bates	ㅂㅔㅇㅣㅊㅡ
mahal	ㅁㅏㅎㅏㄹ
eaton	ㅇㅣㅌㅓㄴ
keitel	ㅋㅏㅇㅣㅌㅔㄹ
wentworth	ㅇㅞㄴㅌㅡㅇㅝㅅㅡ
amin	ㅇㅏㅁㅣㄴ
derek	ㄷㅔㄹㅣㄱ
delon	ㄷㅡㄹㄹㅗㅇ
tiepolo	ㅌㅣㅇㅔㅍㅗㄹㄹㅗ
ferreira	ㅍㅔㅎㅔㅇㅣㄹㅏ
borges	ㅂㅗㄹㅡㅎㅔㅅㅡ
sow	ㅅㅗㅇㅜ
bai	ㅂㅏㅇㅣ
kali	ㅋㅏㄹㄹㅣ
decker	ㄷㅔㅋㅓ
landon	ㄹㅐㄴㄷㅓㄴ
harris	ㅎㅐㄹㅣㅅㅡ
botha	ㅂㅗㅌㅏ
shaka	ㅅㅑㅋㅏ
robbins	ㄹㅗㅂㅣㄴㅅㅡ
enrique	ㅇㅔㄴㄹㅣㅋㅔ
freya	ㅍㅡㄹㅔㅇㅑ
toki	ㄷㅗㅋㅣ
ciro	ㅊㅣㄹㅗ
naim	ㄴㅏㅇㅣㅁ
mariya	ㅁㅏㄹㅣㅇㅑ
gaetano	ㄱㅏㅇㅔㅌㅏㄴㅗ
deon	ㄷㅔㅇㅗㄴ
georgie	ㅈㅗㅈㅣ
lukas	ㄹㅜㅋㅏㅅㅡ
kripke	ㅋㅡㄹㅣㅂㅋㅣ
eucken	ㅇㅗㅇㅣㅋㅔㄴ
vahid	ㅂㅏㅎㅣㄷㅡ
vincent	ㅂㅣㄴㅅㅔㄴㅌㅡ
toral	ㅌㅗㄹㅏㄹ
schmeichel	ㅅㅠㅁㅏㅇㅣㅎㅔㄹ
tokudaiji	ㄷㅗㅋㅜㄷㅏㅇㅣㅈㅣ
kemal	ㅋㅔㅁㅏㄹ
shelton	ㅅㅖㄹㅌㅓㄴ
kathleen	ㅋㅐㅅㅡㄹㄹㅣㄴ
aparecido	ㅇㅏㅍㅏㄹㅔㅅㅣㄷㅜ
upton	ㅇㅓㅂㅌㅓㄴ
yoshimune	ㅇㅛㅅㅣㅁㅜㄴㅔ
malcolm	ㅁㅐㄹㅋㅓㅁ
fabien	ㅍㅏㅂㅣㅇㅐㅇ
timothy	ㅌㅣㅁㅓㅅㅣ
linsey	ㄹㅣㄴㅈㅣ
winnie	ㅇㅟㄴㅣ
elton	ㅇㅔㄹㅌㅓㄴ
alexandre	ㅇㅏㄹㄹㅔㄱㅅㅏㅇㄷㅡㄹㅡ
nataliya	ㄴㅏㅌㅏㄹㄹㅣㅇㅑ
litvinov	ㄹㅣㅌㅡㅂㅣㄴㅗㅍㅡ
red	ㄹㅔㄷㅡ
andrus	ㅇㅏㄴㄷㅡㄹㅜㅅㅡ
gwyneth	ㄱㅟㄴㅔㅅㅡ
womack	ㅇㅝㅁㅐㄱ
andre	ㅇㅏㄴㄷㅡㄹㅔ
hughie	ㅎㅠㅇㅣ
birgitte	ㅂㅣㄹㅡㄱㅣㅌㅔ
fish	ㅍㅣㅅㅣ
abercrombie	ㅇㅐㅂㅓㅋㅡㄹㅗㅁㅂㅣ
saud	ㅅㅏㅇㅜㄷㅡ
mocenigo	ㅁㅗㅊㅔㄴㅣㄱㅗ
elliot	ㅇㅔㄹㄹㅣㅇㅓㅅ
sumpter	ㅅㅓㅁㅍㅡㅌㅓ
shani	ㅅㅑㄴㅣ
daniil	ㄷㅏㄴㅣㄹ
rosi	ㄹㅗㅅㅣ
natasha	ㄴㅏㅌㅏㅅㅑ
anayama	ㅇㅏㄴㅏㅇㅑㅁㅏ
pahlavi	ㅍㅏㄹㄹㅏㅂㅣ
sam	ㅅㅐㅁ
beard	ㅂㅣㅇㅓㄷㅡ
aemilianus	ㅇㅏㅇㅣㅁㅣㄹㄹㅣㅇㅏㄴㅜㅅㅡ
helmut	ㅎㅔㄹㅁㅜㅌㅡ
fitzgerald	ㅍㅣㅊㅡㅈㅔㄹㅓㄹㄷㅡ
bessho	ㅂㅔㅅㅅㅛ
valentina	ㅂㅏㄹㄹㅔㄴㅌㅣㄴㅏ
roth	ㄹㅗㅅㅡ
william	ㅇㅟㄹㄹㅣㅇㅓㅁ
delevingne	ㄷㅔㄹㄹㅔㅂㅏㅇㅣㄴ
rune	ㄹㅜㄴㅔ
irani	ㅇㅣㄹㅏㄴㅣ
gina	ㅈㅣㄴㅏ
mohl	ㅁㅗㄹ
pankhurst	ㅍㅐㅇㅋㅡㅎㅓㅅㅡㅌㅡ
oviedo	ㅇㅗㅂㅣㅇㅔㄷㅗ
bonaparte	ㅂㅗㄴㅏㅍㅏㄹㅡㅌㅡ
georgina	ㅈㅗㅈㅣㄴㅏ
connor	ㅋㅗㄴㅓ
yuya	ㄱㅜㅂㅗ
grazia	ㄱㅡㄹㅏㅊㅣㅇㅏ
gemma	ㅈㅔㅁㅏ
rojas	ㄹㅗㅎㅏㅅㅡ
velasco	ㅂㅔㄹㄹㅏㅅㅡㅋㅗ
jinu	ㅈㅣㄴㅜ
reto	ㄹㅔㅌㅗ
burrows	ㅂㅓㄹㅗㅅㅡ
sutherland	ㅅㅓㄷㅓㄹㄹㅐㄴㄷㅡ
ehud	ㅇㅔㅎㅜㄷㅡ
mccready	ㅁㅐㅋㅡㄹㅣㄷㅣ
urho	ㅇㅜㄹㅡㅎㅗ
jiyul	ㅈㅣㅇㅠㄹ
nacer	ㄴㅏㅅㅔㄹㅡ
georgi	ㄱㅔㅇㅗㄹㅡㄱㅣ
frot	ㅍㅡㄹㅗ
jamie	ㅈㅔㅇㅣㅁㅣ
kamiyama	ㅋㅏㅁㅣㅇㅑㅁㅏ
holder	ㅎㅗㄹㄷㅓ
nobumasa	ㄴㅗㅂㅜㅁㅏㅅㅏ
tomas	ㅌㅗㅁㅏㅅㅡ
mercer	ㅁㅓㅅㅓ
fogerty	ㅍㅗㄱㅓㅌㅣ
tadaakira	ㄷㅏㄷㅏㅇㅏㅋㅣㄹㅏ
ibn	ㅇㅣㅂㅡㄴ
elisabeth	ㅇㅔㄹㄹㅣㅈㅏㅂㅔㅅㅡ
daniyal	ㄷㅏㄴㅣㅇㅑㄹ
hariri	ㅎㅏㄹㅣㄹㅣ
majid	ㅁㅏㅈㅣㄷㅡ
hart	ㅎㅏㅌㅡ
nobuhira	ㄴㅗㅂㅜㅎㅣㄹㅏ
holly	ㅎㅗㄹㄹㅣ
lagarde	ㄹㅏㄱㅏㄹㅡㄷㅡ
kylie	ㅋㅏㅇㅣㄹㄹㅣ
valery	ㅂㅏㄹㄹㅔㄹㅣ
debbi	ㄷㅔㅂㅣ
gerda	ㄱㅔㄹㅡㄷㅏ
the	ㄷㅓ
varro	ㅂㅏㄹㅗ
lua	ㄹㅜㅇㅏ
danila	ㄷㅏㄴㅣㄹㄹㅏ
bennet	ㅂㅔㄴㅔㅅ
gareth	ㄱㅐㄹㅓㅅㅡ
joan	ㅈㅗㅇㅐㄴ
dalia	ㄷㅏㄹㄹㅣㅇㅏ
landry	ㄹㅐㄴㄷㅡㄹㅣ
bernardo	ㅂㅔㄹㅡㄴㅏㄹㅡㄷㅗ
matsui	ㅁㅏㅆㅡㅇㅣ
mckee	ㅁㅐㅋㅣ
horacio	ㅇㅗㄹㅏㅅㅣㅇㅗ
barclay	ㅂㅏㅋㅡㄹㄹㅣ
domenico	ㄷㅗㅁㅔㄴㅣㅋㅗ
whitford	ㅎㅟㅅㅍㅓㄷㅡ
grau	ㄱㅡㄹㅏㅇㅜ
eleonora	ㅇㅔㄹㄹㅔㅇㅗㄴㅗㄹㅏ
kramer	ㅋㅡㄹㅔㅇㅣㅁㅓ
miroslav	ㅁㅣㄹㅗㅅㅡㄹㄹㅏㅍㅡ
virginia	ㅂㅓㅈㅣㄴㅣㅇㅏ
gracchus	ㄱㅡㄹㅏㅋㅜㅅㅡ
charilaos	ㅎㅏㄹㅣㄹㄹㅏㅇㅗㅅㅡ
lleras	ㅇㅖㄹㅏㅅㅡ
chris	ㅋㅡㄹㅣㅅㅡ
ananda	ㅇㅏㄴㅏㄴㄷㅏ
kinoshita	ㄱㅣㄴㅗㅅㅣㅌㅏ
bradford	ㅂㅡㄹㅐㄷㅡㅍㅓㄷㅡ
reizei	ㅊㅓㄴㅎㅘㅇ
stoch	ㅅㅡㅌㅗㅎㅡ
morgenthau	ㅁㅗㄱㅓㄴㅅㅗ
masanaga	ㅁㅏㅅㅏㄴㅏㄱㅏ
mustafa	ㅁㅜㅅㅡㅌㅏㅍㅏ
percy	ㅍㅓㅅㅣ
hendrik	ㅎㅔㄴㄷㅡㄹㅣㄱ
hurst	ㅎㅓㅅㅡㅌㅡ
ernst	ㅇㅔㄹㅡㄴㅅㅡㅌㅡ
konstantinidis	ㅋㅗㄴㅅㅡㅌㅏㄴㅌㅣㄴㅣㄷㅣㅅㅡ
lilly	ㄹㅣㄹㄹㅣ
pound	ㅍㅏㅇㅜㄴㄷㅡ
horn	ㅎㅗㄴ
theodosius	ㅌㅔㅇㅗㄷㅗㅅㅣㅇㅜㅅㅡ
emilia	ㅇㅔㅁㅣㄹㄹㅣㅇㅏ
rosenblatt	ㄹㅗㅈㅔㄴㅂㅡㄹㄹㅏㅌㅡ
rossetti	ㄹㅗㅅㅔㅌㅣ
parke	ㅍㅏㅋㅡ
jerry	ㅈㅔㄹㅣ
elizaveta	ㅇㅖㄹㄹㅣㅈㅏㅂㅔㅌㅏ
pepe	ㅍㅔㅍㅔ
emmanuel	ㅇㅔㅁㅏㄴㅟㅇㅔㄹ
horrocks	ㅎㅗㄹㅗㄱㅅㅡ
kinnunen	ㅋㅣㄴㄴㅜㄴㅔㄴ
estrada	ㅇㅔㅅㅡㅌㅡㄹㅏㄷㅏ
venus	ㅂㅣㄴㅓㅅㅡ
josip	ㅇㅛㅅㅣㅍㅡ
forster	ㅍㅗㅅㅡㅌㅓ
hattusili	ㅎㅏㅌㅜㅅㅣㄹㄹㅣ
jesus	ㅈㅔㅅㅜㅅㅡ
masakatsu	ㅁㅏㅅㅏㅋㅏㅆㅡ
sharon	ㅅㅑㄹㅗㄴ
les	ㄹㅔㅅㅡ
halford	ㅎㅐㄹㅍㅓㄷㅡ
liz	ㄹㅣㅈㅡ
axel	ㅇㅏㄱㅅㅔㄹ
annan	ㅇㅏㄴㅏㄴ
sherwood	ㅅㅕㅇㅜㄷㅡ
fraser	ㅍㅡㄹㅔㅇㅣㅈㅓ
gaviria	ㄱㅏㅂㅣㄹㅣㅇㅏ
mykhailo	ㅁㅣㅎㅏㅇㅣㄹㄹㅗ
wisdom	ㅇㅟㅈㅡㄷㅓㅁ
gaspar	ㄱㅏㅅㅡㅍㅏㄹㅡ
melvil	ㅁㅔㄹㅂㅣㄹ
burak	ㅂㅜㄹㅏㅋㅡ
martino	ㅁㅏㄹㅡㅌㅣㄴㅗ
jinder	ㅈㅣㄴㄷㅓ
polanco	ㅍㅗㄹㄹㅏㅇㅋㅗ
aimee	ㅇㅔㅇㅣㅁㅣ
hemingway	ㅎㅔㅁㅣㅇㅇㅞㅇㅣ
noureddine	ㄴㅜㄹㅔㄷㅣㄴ
bateman	ㅂㅔㅇㅣㅌㅡㅁㅓㄴ
marino	ㅁㅏㄹㅣㄴㅗ
mansur	ㅁㅏㄴㅅㅜㄹㅡ
coachman	ㅋㅗㅊㅣㅁㅐㄴ
indra	ㅇㅣㄴㄷㅡㄹㅏ
mary	ㅁㅔㄹㅣ
giraud	ㅈㅣㄹㅗ
breslin	ㅂㅡㄹㅔㅅㅡㄹㄹㅣㄴ
wilfrid	ㅇㅟㄹㅍㅡㄹㅣㄷㅡ
farah	ㅍㅏㄹㅏ
bah	ㅂㅏ
toshitaka	ㄷㅗㅅㅣㅌㅏㅋㅏ
vojislav	ㅂㅗㅇㅣㅅㅡㄹㄹㅏㅂㅡ
magnussen	ㅁㅐㄱㅡㄴㅓㅅㅡㄴ
mccrory	ㅁㅐㅋㅡㄹㅗㄹㅣ
dandridge	ㄷㅐㄴㄷㅡㄹㅣㅈㅣ
raj	ㄹㅏㅈㅣ
gooding	ㄱㅜㄷㅣㅇ
la	ㄹㅏ
hugues	ㅇㅟㄱㅡ
bernhard	ㅂㅔㄹㅡㄴㅎㅏㄹㅡㅌㅡ
dalessandro	ㄷㅏㄹㄹㅔㅅㅏㄴㄷㅡㄹㅗ
wirth	ㅇㅝㅅㅡ
oliva	ㅇㅗㄹㄹㅣㅂㅏ
ryan	ㄹㅏㅇㅣㅇㅓㄴ
alessia	ㅇㅏㄹㄹㅔㅅㅣㅇㅏ
hannelore	ㅎㅏㄴㅔㄹㄹㅗㄹㅔ
walcott	ㅇㅝㄹㅋㅓㅅ
vijay	ㅂㅣㅈㅔㅇㅣ
lois	ㄹㅗㅇㅣㅅㅡ
krista	ㅋㅡㄹㅣㅅㅡㅌㅏ
maeve	ㅁㅐㅂㅡ
trent	ㅌㅡㄹㅔㄴㅌㅡ
cohen	ㅋㅗㅇㅓㄴ
dely	ㄷㅔㄹㄹㅣ
ewell	ㅇㅣㅇㅞㄹ
clotilde	ㅋㅡㄹㄹㅗㅌㅣㄹㄷㅡ
hidekatsu	ㅎㅣㄷㅔㅋㅏㅆㅡ
spiro	ㅅㅡㅍㅣㄹㅗ
lim	ㄹㅣㅁ
moreau	ㅁㅗㄹㅗ
martha	ㅁㅏㅅㅏ
karlsson	ㅋㅏㄹㅅㅗㄴ
merritt	ㅁㅔㄹㅣㅅ
bale	ㅂㅔㅇㅣㄹ
mumtaz	ㅁㅜㅁㅌㅏㅈㅡ
swift	ㅅㅡㅇㅟㅍㅡㅌㅡ
dhawan	ㄷㅏㅇㅘㄴ
harvey	ㅎㅏㅂㅣ
rossi	ㄹㅗㅅㅣ
mayr	ㅁㅏㅇㅣㅇㅓ
rivera	ㄹㅣㅂㅔㄹㅏ
aika	ㅇㅏㅇㅣㅋㅏ
bismarck	ㅂㅣㅅㅡㅁㅏㄹㅡㅋㅡ
cowell	ㅋㅗㅇㅞㄹ
dillon	ㄷㅣㄹㄹㅓㄴ
orhan	ㅇㅗㄹㅡㅎㅏㄴ
till	ㅌㅣㄹ
ernest	ㅇㅓㄴㅣㅅㅡㅌㅡ
bruch	ㅂㅡㄹㅜㅎㅡ
quincy	ㅋㅟㄴㅅㅣ
kristina	ㅋㅡㄹㅣㅅㅡㅌㅣㄴㅏ
emmerson	ㅇㅔㅁㅓㅅㅡㄴ
poynter	ㅍㅗㅇㅣㄴㅌㅓ
mesa	ㅁㅔㅅㅏ
goddard	ㄱㅗㄷㅏㄷㅡ
hussain	ㅎㅜㅅㅔㅇㅣㄴ
griffin	ㄱㅡㄹㅣㅍㅣㄴ
revell	ㄹㅔㅂㅔㄹ
lee	ㄹㅣ
billie	ㅂㅣㄹㄹㅣ
kameyama	ㅊㅓㄴㅎㅘㅇ
asuka	ㅇㅏㅅㅡㅋㅏ
ashe	ㅇㅐㅅㅣ
jenssen	ㅇㅖㄴㅅㅔㄴ
thug	ㅅㅓㄱㅡ
carlson	ㅋㅏㄹㅅㅡㄴ
stefanie	ㅅㅡㅌㅔㅍㅓㄴㅣ
andriy	ㅇㅏㄴㄷㅡㄹㅣ
cuesta	ㅋㅜㅇㅔㅅㅡㅌㅏ
celina	ㅅㅔㄹㄹㅣㄴㅏ
romain	ㄹㅗㅁㅐㅇ
blackmore	ㅂㅡㄹㄹㅐㄱㅁㅗㅇㅓ
takakage	ㄷㅏㅋㅏㅋㅏㄱㅔ
daley	ㄷㅔㅇㅣㄹㄹㅣ
aleandro	ㅇㅏㄹㄹㅔㅇㅏㄴㄷㅡㄹㅗ
antony	ㅇㅐㄴㅌㅓㄴㅣ
meghan	ㅁㅔㄱㅓㄴ
paula	ㅍㅗㄹㄹㅏ
fenech	ㅍㅔㄴㅔㅊㅣ
priest	ㅍㅡㄹㅣㅅㅡㅌㅡ
darwin	ㄷㅏㅇㅟㄴ
jamal	ㅈㅏㅁㅏㄹ
niro	ㄴㅣㄹㅗ
valentine	ㅂㅐㄹㄹㅓㄴㅌㅏㅇㅣㄴ
loni	ㄹㅗㄴㅣ
zhukovsky	ㅈㅜㅋㅗㅂㅅㅡㅋㅣ
keenan	ㅋㅣㄴㅓㄴ
constance	ㅋㅗㄴㅅㅡㅌㅓㄴㅅㅡ
tomosada	ㄷㅗㅁㅗㅅㅏㄷㅏ
colin	ㅋㅗㄹㄹㅣㄴ
olsson	ㅇㅗㄹㅅㅗㄴ
mariam	ㅁㅏㄹㅣㅇㅏㅁ
iago	ㅇㅣㅇㅏㄱㅗ
dzhokhar	ㅈㅗㅎㅏㄹㅡ
mesut	ㅁㅔㅅㅜㅌㅡ
lalo	ㄹㅏㄹㄹㅗ
bischoff	ㅂㅣㅅㅛㅍㅡ
ahmet	ㅇㅏㅎㅡㅁㅔㅌㅡ
agricola	ㅇㅏㄱㅡㄹㅣㅋㅗㄹㄹㅏ
baer	ㅂㅔㅇㅓ
sylvie	ㅅㅣㄹㅂㅣ
nagahiro	ㄴㅏㄱㅏㅎㅣㄹㅗ
crowe	ㅋㅡㄹㅗ
tolleson	ㅌㅗㄹㄹㅔㅅㅡㄴ
itakura	ㅇㅣㅌㅏㅋㅜㄹㅏ
olivia	ㅇㅗㄹㄹㅣㅂㅣㅇㅏ
goncourt	ㄱㅗㅇㅋㅜㄹㅡ
bennett	ㅂㅔㄴㅔㅅ
cenci	ㅊㅔㄴㅊㅣ
stoner	ㅅㅡㅌㅗㄴㅓ
korolev	ㅋㅗㄹㅗㄹㄹㅛㅍㅡ
saman	ㅅㅏㅁㅏㄴ
banda	ㅂㅏㄴㄷㅏ
maalouf	ㅁㅏㄹㄹㅜㅍㅡ
saura	ㅅㅏㅇㅜㄹㅏ
huma	ㅎㅜㅁㅏ
sheryl	ㅅㅖㄹㅣㄹ
merle	ㅁㅓㄹ
acres	ㅇㅔㅇㅣㅋㅓㅅㅡ
abdul	ㅇㅏㅂㄷㅜㄹ
segura	ㅅㅔㄱㅜㄹㅏ
renee	ㄹㅓㄴㅔ
han	ㅎㅏㄴ
sabri	ㅅㅏㅂㅡㄹㅣ
erich	ㅇㅔㄹㅣㅎㅣ
rudd	ㄹㅓㄷㅡ
dann	ㄷㅐㄴ
blokhin	ㅂㅡㄹㄹㅗㅎㅣㄴ
gassman	ㄱㅏㅅㅡㅁㅏㄴ
hubbard	ㅎㅓㅂㅓㄷㅡ
aguilera	ㅇㅏㄱㅣㄹㄹㅔㄹㅏ
lafontaine	ㄹㅏㅍㅗㄴㅌㅔㅇㅣㄴ
connors	ㅋㅗㄴㅓㅅㅡ
jannik	ㅇㅑㄴㅣㄱ
alban	ㅇㅏㄹㅂㅏㄴ
vitali	ㅂㅣㅌㅏㄹㄹㅣ
mack	ㅁㅐㄱ
skou	ㅅㅡㅋㅗㅇㅜ
keith	ㅋㅣㅅㅡ
pine	ㅍㅏㅇㅣㄴ
williams	ㅇㅟㄹㄹㅣㅇㅓㅁㅅㅡ
pastorelli	ㅍㅏㅅㅡㅌㅗㄹㅔㄹㄹㅣ
mohamed	ㅁㅗㅎㅏㅁㅔㄷㅡ
truman	ㅌㅡㄹㅜㅁㅓㄴ
valdis	ㅂㅏㄹㄷㅣㅅㅡ
vitti	ㅂㅣㅌㅣ
fitzroy	ㅍㅣㅊㅡㄹㅗㅇㅣ
close	ㅋㅡㄹㄹㅗㅅㅡ
zohar	ㅈㅗㅎㅏㄹㅡ
al	ㅇㅏㄹ
hopkins	ㅎㅗㅂㅋㅣㄴㅅㅡ
eyck	ㅇㅔㅇㅣㅋㅡ
ayew	ㅇㅏㅇㅖㅇㅜ
obrien	ㅇㅗㅂㅡㄹㅏㅇㅣㅇㅓㄴ
tess	ㅌㅔㅅㅡ
nicholls	ㄴㅣㅋㅓㄹㅅㅡ
e	ㅇㅣ
erica	ㅇㅔㄹㅣㅋㅏ
sacha	ㅅㅏㅅㅑ
jojo	ㅈㅗㅈㅗ
comstock	ㅋㅗㅁㅅㅡㅌㅗㄱ
mickey	ㅁㅣㅋㅣ
kay	ㅋㅔㅇㅣ
princess	ㅍㅡㄹㅣㄴㅅㅔㅅㅡ
oliveira	ㅇㅗㄹㄹㅣㅂㅔㅇㅣㄹㅏ
armand	ㅇㅏㄹㅡㅁㅏㅇ
pereira	ㅍㅔㄹㅔㅇㅣㄹㅏ
takayoshi	ㄷㅏㅋㅏㅇㅛㅅㅣ
alejandra	ㅇㅏㄹㄹㅔㅎㅏㄴㄷㅡㄹㅏ
liu	ㄹㅠ
childers	ㅊㅣㄹㄷㅓㅅㅡ
cleo	ㅋㅡㄹㄹㅔㅇㅗ
roza	ㄹㅗㅈㅏ
fry	ㅍㅡㄹㅏㅇㅣ
gianfranco	ㅈㅏㄴㅍㅡㄹㅏㅇㅋㅗ
penrose	ㅍㅔㄴㄹㅗㅈㅡ
avram	ㅇㅏㅂㅡㄹㅏㅁ
avery	ㅇㅔㅇㅣㅂㅓㄹㅣ
zachary	ㅈㅐㅋㅓㄹㅣ
kuno	ㅋㅜㄴㅗ
madeleine	ㅁㅐㄷㅡㄹㄹㅣㄴ
stott	ㅅㅡㅌㅗㅅ
michaels	ㅁㅏㅇㅣㅋㅡㄹㅅㅡ
bertil	ㅂㅔㄹㅡㅌㅣㄹ
tempest	ㅌㅔㅁㅍㅔㅅㅡㅌㅡ
lobo	ㄹㅗㅂㅗ
lambert	ㄹㅐㅁㅂㅓㅌㅡ
