laine	ㄹㅔㅇㅣㄴ
soslan	ㅅㅗㅅㅡㄹㄹㅏㄴ
bishop	ㅂㅣㅅㅛㅂ
fredrik	ㅍㅡㄹㅔㄷㅡㄹㅣㅋㅡ
branson	ㅂㅡㄹㅐㄴㅅㅡㄴ
poe	ㅍㅗ
churchill	ㅊㅓㅊㅣㄹ
middleton	ㅁㅣㄷㅡㄹㅌㅓㄴ
qaghan	ㅋㅏㄱㅏㄴ
said	ㅅㅏㅇㅣㄷㅡ
stafford	ㅅㅡㅌㅐㅍㅓㄷㅡ
gilles	ㅈㅣㄹ
helly	ㅎㅔㄹㄹㅣ
dimitri	ㄷㅣㅁㅣㅌㅡㄹㅣ
grinius	ㄱㅡㄹㅣㄴㅣㅇㅜㅅㅡ
feodorovna	ㅍㅛㄷㅗㄹㅗㅂㅡㄴㅏ
logue	ㄹㅗㄱㅡ
vance	ㅂㅐㄴㅅㅡ
noriega	ㄴㅗㄹㅣㅇㅔㄱㅏ
nesbitt	ㄴㅔㅈㅡㅂㅣㅅ
knight	ㄴㅏㅇㅣㅌㅡ
heller	ㅎㅔㄹㄹㅓ
zac	ㅈㅐㄱ
beck	ㅂㅔㅋㅡ
wong	ㅇㅝㅇ
gage	ㄱㅔㅇㅣㅈㅣ
east	ㅇㅣㅅㅡㅌㅡ
alf	ㅇㅏㄹㅍㅡ
frits	ㅍㅡㄹㅣㅊㅡ
tikhonov	ㅌㅣㅎㅗㄴㅗㅍㅡ
riccardo	ㄹㅣㅋㅏㄹㅡㄷㅗ
arnim	ㅇㅏㄹㅡㄴㅣㅁ
aparicio	ㅇㅏㅍㅏㄹㅣㅅㅣㅇㅗ
mauri	ㅁㅏㅇㅜㄹㅣ
sims	ㅅㅣㅁㅅㅡ
jenny	ㅈㅔㄴㅣ
federica	ㅍㅔㄷㅔㄹㅣㅋㅏ
pol	ㅍㅗㄹ
peter	ㅍㅣㅌㅓ
gnaeus	ㄱㅡㄴㅏㅇㅣㅇㅜㅅㅡ
cooke	ㅋㅜㄱ
auguste	ㅇㅗㄱㅟㅅㅡㅌㅡ
rod	ㄹㅗㄷㅡ
joss	ㅈㅗㅅㅡ
little	ㄹㅣㅌㅡㄹ
sheppard	ㅅㅖㅍㅓㄷㅡ
miran	ㅁㅣㄹㅏㄴ
tadachika	ㄷㅏㄷㅏㅊㅣㅋㅏ
dylan	ㄷㅣㄹㄹㅓㄴ
pope	ㅍㅗㅍㅡ
bianchi	ㅂㅣㅇㅏㄴㅋㅣ
bonds	ㅂㅗㄴㅈㅡ
dutt	ㄷㅓㅌㅡ
mattias	ㅁㅏㅌㅣㅇㅏㅅㅡ
newsom	ㄴㅠㅅㅓㅁ
chi	ㅊㅣ
edin	ㅇㅔㄷㅣㄴ
kaufman	ㅋㅗㅍㅡㅁㅓㄴ
lauri	ㄹㅏㅇㅜㄹㅣ
ennio	ㅇㅔㄴㄴㅣㅇㅗ
akira	ㅁㅏㅆㅡㄴㅏㄱㅏ
osman	ㅇㅗㅅㅡㅁㅏㄴ
gish	ㄱㅣㅅㅣ
hooker	ㅎㅜㅋㅓ
perrault	ㅍㅔㄹㅗ
lachman	ㄹㅐㅋㅡㅁㅓㄴ
ulrike	ㅇㅜㄹㄹㅣㅋㅔ
ubaldo	ㅇㅜㅂㅏㄹㄷㅗ
lisa	ㄹㅣㅅㅏ
rama	ㄹㅏㅁㅏ
ralf	ㄹㅏㄹㅍㅡ
aristidis	ㅇㅏㄹㅣㅅㅡㅌㅣㄷㅣㅅㅡ
robert	ㄹㅗㅂㅓㅌㅡ
tal	ㅌㅏㄹ
yasmine	ㅇㅑㅅㅡㅁㅣㄴ
trygve	ㅌㅡㄹㅣㄱㅡㅂㅔ
gyula	ㅈㅜㄹㄹㅓ
angeline	ㅇㅏㄴㅈㅔㄹㄹㅣㄴ
mcdougal	ㅁㅐㄱㄷㅜㄱㅓㄹ
piccard	ㅍㅣㅋㅏㄹㅡ
simone	ㅅㅣㅁㅗㄴ
stults	ㅅㅡㅌㅓㄹㅊㅡ
posey	ㅍㅗㅈㅣ
bramlett	ㅂㅡㄹㅐㅁㄹㅣㅅ
march	ㅁㅏㅊㅣ
gorilla	ㄱㅗㄹㅣㄹㄹㅏ
vyacheslav	ㅂㅑㅊㅔㅅㅡㄹㄹㅏㅍㅡ
harriet	ㅎㅐㄹㅣㅇㅓㅅ
foley	ㅍㅗㄹㄹㅣ
erving	ㅇㅓㅂㅣㅇ
motoharu	ㅁㅗㅌㅗㅎㅏㄹㅜ
lady	ㄹㅔㅇㅣㄷㅣ
moro	ㅁㅗㄹㅗ
niebuhr	ㄴㅣㅂㅜㅇㅓ
franck	ㅍㅡㄹㅏㅇㅋㅡ
pasha	ㅍㅏㅅㅑ
amorim	ㅇㅏㅁㅗㄹㅣㅇ
pearson	ㅍㅣㅇㅓㅅㅡㄴ
stepan	ㅅㅡㅌㅔㅍㅏㄴ
conrad	ㅋㅗㄴㄹㅐㄷㅡ
casadesus	ㅋㅏㅈㅏㄷㅡㅈㅟ
habib	ㅎㅏㅂㅣㅂㅡ
toshimichi	ㄷㅗㅅㅣㅁㅣㅊㅣ
paz	ㅍㅏㅅㅡ
maryam	ㅁㅏㄹㅣㅇㅏㅁ
lucille	ㄹㅜㅅㅣㄹ
monica	ㅁㅗㄴㅣㅋㅏ
ravel	ㄹㅏㅂㅔㄹ
ewa	ㅇㅔㅂㅏ
papandreou	ㅍㅏㅍㅏㄴㄷㅡㄹㅔㅇㅜ
cox	ㅋㅗㄱㅅㅡ
ewen	ㅇㅠㅇㅓㄴ
valentin	ㅂㅏㄹㄹㅔㄴㅌㅣㄴ
gotti	ㄱㅏㅌㅣ
garth	ㄱㅏㅅㅡ
priuli	ㅍㅡㄹㅣㅇㅜㄹㄹㅣ
swann	ㅅㅡㅇㅘㄴ
ringer	ㄹㅣㅇㄱㅓ
nana	ㄴㅏㄴㅏ
chevalier	ㅅㅠㅂㅏㄹㄹㅣㅇㅔ
tan	ㅌㅏㄴ
hilty	ㅎㅣㄹㅌㅣ
hamill	ㅎㅐㅁㅣㄹ
chelsea	ㅊㅔㄹㅅㅣ
mcpartlin	ㅁㅐㄱㅍㅏㅌㅡㄹㄹㅣㄴ
kieft	ㅋㅣㅍㅡㅌㅡ
elisabetta	ㅇㅔㄹㄹㅣㅅㅏㅂㅔㅌㅏ
hawk	ㅎㅗㅋㅡ
thomas	ㅌㅗㅁㅓㅅㅡ
simpkins	ㅅㅣㅁㅍㅡㅋㅣㄴㅅㅡ
damian	ㄷㅔㅁㅣㅇㅓㄴ
afonso	ㅇㅏㅍㅗㄴㅅㅜ
mills	ㅁㅣㄹㅅㅡ
slater	ㅅㅡㄹㄹㅔㅇㅣㅌㅓ
goodman	ㄱㅜㅅㅁㅐㄴ
mustapha	ㅁㅜㅅㅡㅌㅏㅍㅏ
cahill	ㅋㅔㅇㅣㅎㅣㄹ
maxwell	ㅁㅐㄱㅅㅡㅇㅞㄹ
shimizu	ㅅㅣㅁㅣㅈㅡ
maximiliano	ㅁㅏㄱㅅㅣㅁㅣㄹㄹㅣㅇㅏㄴㅗ
oswald	ㅇㅗㅈㅡㅇㅝㄹㄷㅡ
gay	ㄱㅔㅇㅣ
yoshinaga	ㅇㅛㅅㅣㄴㅏㄱㅏ
money	ㅁㅓㄴㅣ
beach	ㅂㅣㅊㅣ
luise	ㄹㅜㅇㅣㅈㅔ
woolf	ㅇㅜㄹㅍㅡ
oksana	ㅇㅗㄱㅅㅏㄴㅏ
hagi	ㅎㅏㅈㅣ
janda	ㅇㅑㄴㄷㅏ
bahadur	ㅂㅏㅎㅏㄷㅜㄹㅡ
wood	ㅇㅜㄷㅡ
jeremy	ㅈㅔㄹㅓㅁㅣ
edu	ㅇㅔㄷㅜ
nathalia	ㄴㅏㅌㅏㄹㄹㅣㅇㅏ
jimmy	ㅈㅣㅁㅣ
devonshire	ㅂㅜㅇㅣㄴ
willett	ㅇㅟㄹㄹㅔㅅ
manoel	ㅁㅏㄴㅗㅇㅔㅇㅜ
julio	ㅎㅜㄹㄹㅣㅇㅗ
farman	ㅍㅏㄹㅡㅁㅏㅇ
saussure	ㅅㅗㅅㅟㄹㅡ
harrison	ㅎㅐㄹㅣㅅㅡㄴ
alvin	ㅇㅐㄹㅂㅣㄴ
petrucci	ㅍㅔㅌㅡㄹㅜㅊㅣ
cardoso	ㅋㅏㄹㅡㄷㅗㅈㅜ
callum	ㅋㅐㄹㄹㅓㅁ
worth	ㅇㅝㅅㅡ
bayezid	ㅂㅏㅇㅖㅈㅣㄷㅡ
cartier	ㅋㅏㄹㅡㅌㅣㅇㅔ
wolski	ㅂㅗㄹㅅㅡㅋㅣ
lance	ㄹㅐㄴㅅㅡ
morison	ㅁㅗㄹㅣㅅㅡㄴ
justin	ㅈㅓㅅㅡㅌㅣㄴ
eugene	ㅇㅠㅈㅣㄴ
chandler	ㅊㅐㄴㄷㅡㄹㄹㅓ
ingram	ㅇㅣㅇㄱㅡㄹㅐㅁ
richardson	ㄹㅣㅊㅓㄷㅡㅅㅡㄴ
corinna	ㅋㅗㄹㅣㄴㄴㅏ
rashid	ㄹㅏㅅㅣㄷㅡ
crassus	ㅋㅡㄹㅏㅅㅜㅅㅡ
shearer	ㅅㅣㅇㅓㄹㅓ
arvo	ㅇㅏㄹㅡㅂㅗ
castle	ㅋㅐㅅㅡㄹ
ikeda	ㅇㅣㅋㅔㄷㅏ
gylfi	ㄱㅣㄹㅍㅣ
wallace	ㅇㅝㄹㄹㅣㅅㅡ
baldini	ㅂㅏㄹㄷㅣㄴㅣ
batten	ㅂㅐㅌㅡㄴ
cheryl	ㅅㅖㄹㅣㄹ
brutus	ㅂㅡㄹㅜㅌㅜㅅㅡ
joely	ㅈㅗㅇㅔㄹㄹㅣ
visconti	ㅂㅣㅅㅡㅋㅗㄴㅌㅣ
fernand	ㅍㅔㄹㅡㄴㅏㅇ
cesar	ㅅㅔㅈㅏㄹㅡ
mcgowan	ㅁㅐㄱㄱㅗㅇㅘㄴ
catharina	ㅋㅏㅌㅏㄹㅣㄴㅏ
tomoyuki	ㅎㅣㄱㅜㅊㅣ
clooney	ㅋㅡㄹㄹㅜㄴㅣ
levine	ㄹㅓㅂㅏㅇㅣㄴ
yasuyoshi	ㅇㅑㅅㅡㅇㅛㅅㅣ
edmond	ㅇㅔㄷㅡㅁㅗㅇ
isa	ㅇㅣㅅㅏ
casimir	ㅋㅏㅅㅣㅁㅣㄹㅡ
lundqvist	ㄹㅜㄴㄷㅡㅋㅡㅂㅣㅅㅡㅌㅡ
gala	ㄱㅏㄹㄹㅏ
masako	ㅁㅏㅅㅏㅋㅗ
ordelaffi	ㅇㅗㄹㅡㄷㅔㄹㄹㅏㅍㅣ
hanks	ㅎㅐㅇㅋㅡㅅㅡ
flores	ㅍㅡㄹㄹㅗㄹㅔㅅㅡ
molly	ㅁㅗㄹㄹㅣ
ezequiel	ㅇㅔㅅㅔㅋㅣㅇㅔㄹ
ann	ㅇㅐㄴ
lakshmi	ㄹㅏㄱㅅㅠㅁㅣ
lewandowski	ㄹㅔㅂㅏㄴㄷㅗㅍㅡㅅㅡㅋㅣ
giacomo	ㅈㅏㅋㅗㅁㅗ
bastien	ㅂㅏㅅㅡㅌㅣㅇㅏㅇ
stillman	ㅅㅡㅌㅣㄹㅁㅓㄴ
pete	ㅍㅣㅌㅡ
brin	ㅂㅡㄹㅣㄴ
rau	ㄹㅏㅇㅜ
yusuf	ㅇㅠㅅㅜㅍㅡ
hector	ㅎㅔㄱㅌㅗㅇㅓ
hobson	ㅎㅗㅂㅅㅡㄴ
flanagan	ㅍㅡㄹㄹㅐㄴㅓㄱㅓㄴ
colm	ㅋㅓㅁ
ramsay	ㄹㅐㅁㅈㅣ
jari	ㅇㅑㄹㅣ
chance	ㅊㅏㄴㅅㅡ
aki	ㅇㅏㅋㅣ
frederick	ㅍㅡㄹㅔㄷㅓㄹㅣㄱ
enes	ㅇㅔㄴㅔㅅㅡ
tadakuni	ㄷㅏㄷㅏㅋㅜㄴㅣ
alley	ㅇㅐㄹㄹㅣ
bohumil	ㅂㅗㅎㅜㅁㅣㄹ
mcintyre	ㅁㅐㅋㅣㄴㅌㅏㅇㅣㅇㅓ
eric	ㅇㅔㄹㅣㄱ
duje	ㄷㅜㅇㅖ
randi	ㄹㅐㄴㄷㅣ
nirari	ㄴㅣㄹㅏㄹㅣ
morakis	ㅁㅗㄹㅏㅋㅣㅅㅡ
theodora	ㅌㅔㅇㅗㄷㅗㄹㅏ
yukio	ㅇㅗㅈㅏㅋㅣ
coulibaly	ㅋㅜㄹㄹㅣㅂㅏㄹㄹㅣ
babunski	ㅂㅏㅂㅜㄴㅅㅡㅋㅣ
ole	ㅇㅗㄹㄹㅔ
rae	ㄹㅔㅇㅣ
hancock	ㅎㅐㄴㅋㅗㄱ
kikuchi	ㄱㅏㄴ
annable	ㅇㅐㄴㅏㅂㅡㄹ
cooper	ㅋㅜㅍㅓ
toshikatsu	ㄷㅗㅅㅣㅋㅏㅆㅡ
cookson	ㅋㅜㄱㅅㅡㄴ
milutin	ㅁㅣㄹㄹㅜㅌㅣㄴ
vinnie	ㅂㅣㄴㅣ
garland	ㄱㅏㄹㄹㅐㄴㄷㅡ
galli	ㄱㅏㄹㄹㅣ
yolanda	ㅇㅛㄹㄹㅏㄴㄷㅏ
vergara	ㅂㅔㄹㅡㄱㅏㄹㅏ
ian	ㅇㅣㅇㅓㄴ
haggard	ㅎㅐㄱㅓㄷㅡ
anett	ㅇㅏㄴㅔㅌㅡ
hillary	ㅎㅣㄹㄹㅓㄹㅣ
keri	ㅋㅔㄹㅣ
shay	ㅅㅖㅇㅣ
london	ㄹㅓㄴㄷㅓㄴ
iain	ㅇㅣㅇㅓㄴ
leroy	ㄹㅣㄹㅗㅇㅣ
rossellini	ㄹㅗㅅㅔㄹㄹㅣㄴㅣ
church	ㅊㅓㅊㅣ
tommy	ㅌㅗㅁㅣ
bull	ㅂㅜㄹ
grace	ㄱㅡㄹㅔㅇㅣㅅㅡ
fitzpatrick	ㅍㅣㅊㅡㅍㅐㅌㅡㄹㅣㄱ
deste	ㄷㅔㅅㅡㅌㅔ
cova	ㅋㅗㅂㅏ
kidman	ㅋㅣㄷㅡㅁㅓㄴ
smirnov	ㅅㅡㅁㅣㄹㅡㄴㅗㅍㅡ
yoshitsugu	ㅇㅛㅅㅣㅆㅡㄱㅜ
lake	ㄹㅔㅇㅣㅋㅡ
carpenter	ㅋㅏㅍㅔㄴㅌㅓ
getty	ㄱㅔㅌㅣ
mcdonald	ㅁㅐㄱㄷㅗㄴㅓㄹㄷㅡ
yorinobu	ㅇㅛㄹㅣㄴㅗㅂㅜ
santo	ㅅㅏㄴㅌㅗ
greenwood	ㄱㅡㄹㅣㄴㅇㅜㄷㅡ
obama	ㅇㅗㅂㅏㅁㅏ
shirin	ㅅㅣㄹㅣㄴ
darine	ㄷㅏㄹㅣㄴ
degli	ㄷㅔㄹㄹㅣ
sala	ㅅㅏㄹㄹㅏ
una	ㅇㅜㄴㅏ
bagley	ㅂㅐㄱㅡㄹㄹㅣ
snyder	ㅅㅡㄴㅏㅇㅣㄷㅓ
charlotte	ㅅㅑㄹㄹㅓㅅ
depardieu	ㄷㅡㅍㅏㄹㅡㄷㅣㅇㅚ
banks	ㅂㅐㅇㅋㅡㅅㅡ
vieira	ㅂㅣㅇㅔㅇㅣㄹㅏ
kaarlo	ㅋㅏㄹㅡㄹㄹㅗ
davis	ㄷㅔㅇㅣㅂㅣㅅㅡ
riva	ㄹㅣㅂㅏ
iglesias	ㅇㅣㄱㅡㄹㄹㅔㅅㅣㅇㅏㅅㅡ
damboise	ㄷㅏㅇㅂㅜㅇㅏㅈㅡ
farahani	ㅍㅏㄹㅏㅎㅏㄴㅣ
macarthur	ㅁㅐㄱㅇㅏㄷㅓ
haley	ㅎㅔㅇㅣㄹㄹㅣ
menotti	ㅁㅔㄴㅗㅌㅣ
oz	ㅇㅗㅈㅡ
cordeiro	ㅋㅗㄹㅡㄷㅔㅇㅣㄹㅜ
jalil	ㅈㅏㄹㄹㅣㄹ
lionel	ㄹㅣㅇㅗㄴㅔㄹ
marat	ㅁㅏㄹㅏㅌㅡ
ilie	ㅇㅣㄹㄹㅣㅇㅔ
lord	ㄹㅗㄷㅡ
wolde	ㅇㅝㄹㄷㅔ
toninho	ㅌㅗㄴㅣㄴㅠ
walker	ㅇㅝㅋㅓ
joanna	ㅈㅗㅇㅐㄴㅏ
neill	ㄴㅣㄹ
luther	ㄹㅜㅅㅓ
bastian	ㅂㅏㅅㅡㅌㅣㅇㅏㄴ
holger	ㅎㅗㄹㄱㅓ
baird	ㅂㅔㅇㅓㄷㅡ
almir	ㅇㅏㅇㅜㅁㅣㄹㅡ
bellini	ㅂㅔㄹㄹㅣㄴㅣ
espen	ㅇㅔㅅㅡㅍㅔㄴ
haden	ㅎㅔㅇㅣㄷㅡㄴ
krzysztof	ㅋㅡㅅㅣㅅㅠㅌㅗㅍㅡ
richard	ㄹㅣㅊㅓㄷㅡ
kinski	ㅋㅣㄴㅅㅡㅋㅣ
maiko	ㅁㅏㅇㅣㅋㅗ
nino	ㄴㅣㄴㅗ
jepsen	ㅈㅔㅂㅅㅡㄴ
luxemburg	ㄹㅜㄱㅅㅔㅁㅂㅜㄹㅡㅋㅡ
nansen	ㄴㅏㄴㅅㅔㄴ
of	ㄷㅡ
ulrich	ㅇㅜㄹㄹㅣㅎㅣ
fontaine	ㅍㅗㅇㅌㅔㄴ
katarzyna	ㅋㅏㅌㅏㅈㅣㄴㅏ
harper	ㅎㅏㅍㅓ
massoud	ㅁㅏㅅㅜㄷㅡ
katsuyuki	ㄱㅏㅆㅡㅇㅠㅋㅣ
granit	ㄱㅡㄹㅏㄴㅣㅌㅡ
hilda	ㅎㅣㄹㄷㅏ
reese	ㄹㅣㅅㅡ
naoki	ㄷㅏㅋㅏㅎㅏㅅㅣ
mamadou	ㅁㅏㅁㅏㄷㅜ
mcrae	ㅁㅐㄱㄹㅔㅇㅣ
ron	ㄹㅗㄴ
irene	ㅇㅣㄹㅔㄴㅔ
hanratty	ㅎㅐㄴㄹㅐㅌㅣ
linton	ㄹㅣㄴㅌㅓㄴ
siegel	ㅅㅣㄱㅓㄹ
litherland	ㄹㅣㄷㅓㄹㄹㅐㄴㄷㅡ
wittgenstein	ㅂㅣㅌㅡㄱㅔㄴㅅㅠㅌㅏㅇㅣㄴ
kosuke	ㅇㅗㅌㅏ
mason	ㅁㅔㅇㅣㅅㅡㄴ
rufus	ㄹㅜㅍㅓㅅㅡ
garza	ㄱㅏㅈㅏ
tsugaru	ㅆㅡㄱㅏㄹㅜ
mckinley	ㅁㅐㅋㅣㄴㄹㅣ
erwin	ㅇㅔㄹㅡㅂㅣㄴ
sho	ㅅㅛ
rade	ㄹㅏㄷㅔ
friend	ㅍㅡㄹㅔㄴㄷㅡ
davy	ㄷㅏㅂㅣ
ruth	ㄹㅜㅅㅡ
palmer	ㅍㅏㅁㅓ
rob	ㄹㅗㅂ
ruben	ㄹㅜㅂㅔㄴ
zapata	ㅅㅏㅍㅏㅌㅏ
johannes	ㅇㅛㅎㅏㄴㅔㅅㅡ
alejandro	ㅇㅏㄹㄹㅔㅎㅏㄴㄷㅡㄹㅗ
pascal	ㅍㅏㅅㅡㅋㅏㄹ
wa	ㅇㅘ
monique	ㅁㅗㄴㅣㅋㅡ
maddux	ㅁㅐㄷㅓㄱㅅㅡ
strait	ㅅㅡㅌㅡㄹㅔㅇㅣㅌㅡ
debra	ㄷㅔㅂㅡㄹㅏ
robby	ㄹㅗㅂㅣ
maxime	ㅁㅏㄱㅅㅣㅁ
irons	ㅇㅏㅇㅣㅇㅓㄴㅅㅡ
tyler	ㅌㅏㅇㅣㄹㄹㅓ
edwin	ㅇㅔㄷㅡㅇㅟㄴ
paredes	ㅍㅏㄹㅔㄷㅔㅅㅡ
knapp	ㄴㅐㅂ
hein	ㅎㅏㅇㅣㄴ
nerlinger	ㄴㅔㄹㅡㄹㄹㅣㅇㄱㅓ
menzies	ㅁㅔㄴㅈㅣㅅㅡ
dolphy	ㄷㅗㄹㅍㅣ
friedrich	ㅍㅡㄹㅣㄷㅡㄹㅣㅎㅣ
deepika	ㄷㅣㅍㅣㅋㅏ
frost	ㅍㅡㄹㅗㅅㅡㅌㅡ
adalbert	ㅇㅏㄷㅏㄹㅂㅔㄹㅡㅌㅡ
san	ㅅㅏㄴ
lori	ㄹㅗㄹㅣ
julian	ㅈㅜㄹㄹㅣㅇㅓㄴ
suzi	ㅅㅜㅈㅣ
yamauchi	ㅇㅑㅁㅏㅇㅜㅊㅣ
flint	ㅍㅡㄹㄹㅣㄴㅌㅡ
devon	ㄷㅔㅂㅓㄴ
jacqueline	ㅈㅐㅋㅡㄹㄹㅣㄴ
everett	ㅇㅔㅂㅓㄹㅔㅅ
fontana	ㅍㅗㄴㅌㅏㄴㅏ
betancourt	ㅂㅔㅌㅏㅇㅋㅜㄹㅡ
roa	ㄹㅗㅇㅏ
dumas	ㄷㅟㅁㅏ
laurent	ㄹㅗㄹㅏㅇ
ricardo	ㄹㅣㅋㅏㄹㅡㄷㅗ
christine	ㅋㅡㄹㅣㅅㅡㅌㅣㄴ
horta	ㅇㅗㄹㅡㅌㅏ
mount	ㅁㅏㅇㅜㄴㅌㅡ
mackintosh	ㅁㅐㅋㅣㄴㅌㅗㅅㅣ
krupa	ㅋㅡㄹㅜㅍㅏ
ragnar	ㄹㅏㄱㅡㄴㅏㄹㅡ
stacy	ㅅㅡㅌㅔㅇㅣㅅㅣ
amel	ㅇㅏㅁㅔㄹ
beatrice	ㅂㅔㅇㅏㅌㅡㄹㅣㅊㅔ
ashikaga	ㅇㅏㅅㅣㅋㅏㄱㅏ
holbrook	ㅎㅗㄹㅂㅡㄹㅜㄱ
forman	ㅍㅗㅁㅓㄴ
sykes	ㅅㅏㅇㅣㅋㅡㅅㅡ
shaito	ㅅㅑㅇㅣㅌㅗ
ua	ㅇㅜㅇㅓ
harlan	ㅎㅏㄹㄹㅓㄴ
elia	ㅇㅔㄹㄹㅣㅇㅏ
silvia	ㅅㅣㄹㅂㅣㅇㅏ
chet	ㅊㅔㅅ
peixoto	ㅍㅔㅇㅣㅅㅛㅌㅜ
starr	ㅅㅡㅌㅏ
judge	ㅈㅓㅈㅣ
hynes	ㅎㅏㅇㅣㄴㅅㅡ
priscilla	ㅍㅡㄹㅣㅅㅣㄹㄹㅏ
najwa	ㄴㅏㅈㅡㅇㅘ
berg	ㅂㅓㄱㅡ
humboldt	ㅎㅜㅁㅂㅗㄹㅌㅡ
bruckner	ㅂㅡㄹㅜㅋㅡㄴㅓ
beau	ㅂㅗ
akihiro	ㅅㅏㅌㅗ
rami	ㄹㅏㅁㅣ
sigebert	ㅈㅣㄱㅔㅂㅔㄹㅡㅌㅡ
keir	ㅋㅣㅇㅓ
wray	ㄹㅔㅇㅣ
pierluigi	ㅍㅣㅇㅔㄹㅡㄹㄹㅜㅇㅣㅈㅣ
disney	ㄷㅣㅈㅡㄴㅣ
freud	ㅍㅡㄹㅗㅇㅣㅌㅡ
wadsworth	ㅇㅝㅈㅡㅇㅝㅅㅡ
bradley	ㅂㅡㄹㅐㄷㅡㄹㄹㅣ
kiefer	ㅋㅣㅍㅓ
sheila	ㅅㅟㄹㄹㅏ
roxane	ㄹㅗㄱㅅㅏㄴ
wilder	ㅇㅘㅇㅣㄹㄷㅓ
julie	ㅈㅜㄹㄹㅣ
breen	ㅂㅡㄹㅣㄴ
nascimento	ㄴㅏㅅㅣㅁㅔㄴㅌㅜ
christy	ㅋㅡㄹㅣㅅㅡㅌㅣ
reinhardt	ㄹㅏㅇㅣㄴㅎㅏㄹㅡㅌㅡ
drover	ㄷㅡㄹㅗㅂㅓ
huda	ㅎㅜㄷㅏ
dustin	ㄷㅓㅅㅡㅌㅣㄴ
simonsen	ㅅㅣㅁㅗㄴㅅㅔㄴ
morten	ㅁㅗㄹㅡㅌㅔㄴ
bathurst	ㅂㅐㅅㅓㅅㅡㅌㅡ
woodward	ㅇㅜㄷㅡㅇㅝㄷㅡ
pascale	ㅍㅏㅅㅡㅋㅏㄹ
queen	ㅋㅟㄴ
weaving	ㅇㅟㅂㅣㅇ
grove	ㄱㅡㄹㅗㅂㅡ
puig	ㅍㅜㅇㅣㄱㅡ
ramin	ㄹㅏㅁㅣㄴ
courtney	ㅋㅗㅌㅡㄴㅣ
gaynor	ㄱㅔㅇㅣㄴㅓ
brentano	ㅂㅡㄹㅔㄴㅌㅏㄴㅗ
bret	ㅂㅡㄹㅔㅅ
camilo	ㅋㅏㅁㅣㄹㄹㅗ
kenney	ㅋㅔㄴㅣ
jacinto	ㅎㅏㅅㅣㄴㅌㅗ
whittaker	ㅎㅟㅌㅐㅋㅓ
nobutsune	ㄴㅗㅂㅜㅆㅡㄴㅔ
brody	ㅂㅡㄹㅗㄷㅣ
lisbet	ㄹㅣㅅㅡㅂㅔㅌㅡ
maggio	ㅁㅏㅈㅗ
rolf	ㄹㅗㄹㅍㅡ
clark	ㅋㅡㄹㄹㅏㅋㅡ
habermas	ㅎㅏㅂㅓㅁㅏㅅㅡ
garrel	ㄱㅏㄹㅔㄹ
karol	ㅋㅏㄹㅗㄹ
redman	ㄹㅔㄷㅡㅁㅐㄴ
wylie	ㅇㅘㅇㅣㄹㄹㅣ
jonasson	ㅇㅛㄴㅏㅅㅗㄴ
tadataka	ㄷㅏㄷㅏㅌㅏㅋㅏ
carlos	ㅋㅏㄹㅡㄹㄹㅗㅅㅡ
hough	ㅎㅓㅍㅡ
mantel	ㅁㅐㄴㅌㅡㄹ
kavita	ㅋㅏㅂㅣㅌㅏ
whitfield	ㅎㅟㅅㅍㅣㄹㄷㅡ
infante	ㅇㅣㄴㅍㅏㄴㅌㅔ
shroff	ㅅㅠㄹㅗㅍㅡ
antonio	ㅇㅏㄴㅌㅗㄴㅣㅇㅗ
crumb	ㅋㅡㄹㅓㅁ
carvalho	ㅋㅏㄹㅡㅂㅏㄹㄹㅠ
bobadilla	ㅂㅗㅂㅏㄷㅣㅇㅑ
saavedra	ㅅㅏㅂㅔㄷㅡㄹㅏ
fowler	ㅍㅏㅇㅜㄹㄹㅓ
priya	ㅍㅡㄹㅣㅇㅑ
cage	ㅋㅔㅇㅣㅈㅣ
bobbi	ㅂㅗㅂㅣ
melody	ㅁㅔㄹㄹㅗㄷㅣ
chappell	ㅊㅐㅍㅡㄹ
farhadi	ㅍㅏㄹㅡㅎㅏㄷㅣ
constantin	ㅋㅗㄴㅅㅡㅌㅏㄴㅌㅣㄴ
kingston	ㅋㅣㅇㅅㅡㅌㅓㄴ
shauna	ㅅㅛㄴㅏ
vadim	ㅂㅏㄷㅣㅁ
sabu	ㅅㅏㅂㅜ
djamel	ㅈㅏㅁㅔㄹ
fuad	ㅍㅜㅇㅏㄷㅡ
jeffrey	ㅈㅔㅍㅡㄹㅣ
tadaoki	ㄷㅏㄷㅏㅇㅗㅋㅣ
bardem	ㅂㅏㄹㅡㄷㅔㅁ
richards	ㄹㅣㅊㅓㅈㅡ
hayden	ㅎㅔㅇㅣㄷㅡㄴ
brandon	ㅂㅡㄹㅐㄴㄷㅓㄴ
hargreaves	ㅎㅏㄱㅡㄹㅣㅂㅡㅅㅡ
buffett	ㅂㅓㅍㅣㅅ
dagmar	ㄷㅏㄱㅡㅁㅏㄹㅡ
dafne	ㄷㅏㅍㅡㄴㅔ
adi	ㅇㅏㄷㅣ
takatomo	ㄷㅏㅋㅏㅌㅗㅁㅗ
feldman	ㅍㅔㄹㄷㅡㅁㅓㄴ
oldham	ㅇㅗㄹㄷㅓㅁ
niels	ㄴㅣㄹㅅㅡ
wil	ㅇㅟㄹ
coulter	ㅋㅗㄹㅌㅓ
ai	ㅇㅏㅇㅣ
nic	ㄴㅣㄱ
nadia	ㄴㅏㄷㅣㅇㅏ
boggs	ㅂㅗㄱㅡㅅㅡ
wanamaker	ㅇㅝㄴㅓㅁㅔㅇㅣㅋㅓ
herod	ㅎㅔㄹㅗㄷㅔ
volker	ㅍㅗㄹㅋㅓ
bartlett	ㅂㅏㅌㅡㄹㄹㅣㅅ
hall	ㅎㅗㄹ
regis	ㄹㅔㅈㅣㅅㅡ
berardi	ㅂㅔㄹㅏㄹㅡㄷㅣ
pavlovich	ㅍㅏㅂㅡㄹㄹㅗㅂㅣㅊㅣ
quaid	ㅋㅞㅇㅣㄷㅡ
aguirre	ㅇㅏㄱㅣㄹㅔ
ricker	ㄹㅣㅋㅓ
zhang	ㅈㅏㅇ
ricky	ㄹㅣㅋㅣ
dwight	ㄷㅡㅇㅘㅇㅣㅌㅡ
kaoru	ㄱㅏㅇㅗㄹㅜ
yasmin	ㅇㅑㅅㅡㅁㅣㄴ
frank	ㅍㅡㄹㅐㅇㅋㅡ
arora	ㅇㅏㄹㅗㄹㅏ
day	ㄷㅔㅇㅣ
rochelle	ㄹㅗㅅㅖㄹ
guerra	ㄱㅔㄹㅏ
janghyun	ㅈㅏㅇㅎㅕㄴ
hiller	ㅎㅣㄹㄹㅓ
honda	ㅎㅗㄴㄷㅏ
seaver	ㅅㅣㅂㅓ
skylar	ㅅㅡㅋㅏㅇㅣㄹㄹㅏ
caulfield	ㅋㅗㄹㅍㅣㄹㄷㅡ
sabina	ㅅㅏㅂㅣㄴㅏ
bodil	ㅂㅗㄷㅣㄹ
memushaj	ㅁㅔㅁㅜㅅㅑㅇㅣ
favino	ㅍㅏㅂㅣㄴㅗ
antonia	ㅇㅐㄴㅌㅗㄴㅣㅇㅏ
kendrys	ㅋㅔㄴㄷㅡㄹㅣ
wakatsuki	ㅇㅘㅋㅏㅆㅡㅋㅣ
glenda	ㄱㅡㄹㄹㅔㄴㄷㅏ
aoun	ㅇㅏㅇㅜㄴ
nayer	ㄴㅔㅇㅣㅇㅓ
speroni	ㅅㅡㅍㅔㄹㅗㄴㅣ
ruffalo	ㄹㅓㅍㅏㄹㄹㅗ
gotovac	ㄱㅗㅌㅗㅂㅏㅊㅡ
mandorlini	ㅁㅏㄴㄷㅗㄹㅡㄹㄹㅣㄴㅣ
gliha	ㄱㅡㄹㄹㅣㅎㅏ
angoua	ㅇㅏㅇㄱㅜㅇㅏ
baye	ㅂㅔㅇㅣ
ganda	ㄱㅏㄴㄷㅏ
bertolini	ㅂㅔㄹㅡㅌㅗㄹㄹㅣㄴㅣ
flamsteed	ㅍㅡㄹㄹㅐㅁㅅㅡㅌㅣㄷㅡ
delpierre	ㄷㅔㄹㅍㅣㅇㅔㄹㅡ
devgan	ㄷㅔㅂㅡㄴ
gutmann	ㄱㅜㅌㅡㅁㅏㄴ
wackerman	ㅇㅘㅋㅓㅁㅓㄴ
lelord	ㄹㅡㄹㄹㅗㄹㅡ
goodger	ㄱㅜㅈㅓ
jazztronik	ㅈㅐㅈㅡㅌㅡㄹㅗㄴㅣㄱ
firestone	ㅍㅏㅇㅣㅇㅓㅅㅡㅌㅗㄴ
frevert	ㅍㅡㄹㅔㅂㅔㄹㅡㅌㅡ
grella	ㄱㅡㄹㅔㄹㄹㅏ
mudingayi	ㅁㅜㄷㅣㅇㄱㅏㅇㅣ
sapochnik	ㅅㅓㅍㅗㅋㅡㄴㅣㄱ
ujitaka	ㅇㅜㅈㅣㅌㅏㅋㅏ
senbonmatsu	ㅋㅣㅎㅔㅇㅔ
hisayasu	ㅎㅣㅅㅏㅇㅑㅅㅡ
schlemmer	ㅅㅠㄹㄹㅔㅁㅓ
bonnet	ㅂㅗㄴㅔ
helgesson	ㅎㅔㄹㄱㅔㅅㅗㄴ
kosgei	ㅋㅗㅅㅡㄱㅔㅇㅣ
stramm	ㅅㅠㅌㅡㄹㅏㅁ
mahone	ㅁㅓㅎㅗㄴ
papiss	ㅍㅏㅍㅣㅅㅡ
winslow	ㅇㅟㄴㅅㅡㄹㄹㅗㅇㅜ
bademsoy	ㅂㅏㄷㅔㅁㅅㅗㅇㅣ
syagrius	ㅅㅣㅇㅏㄱㅡㄹㅣㅇㅜㅅㅡ
shoshannah	ㅅㅛㅅㅒㄴㅏ
venny	ㅂㅔㄴㅣ
ilyich	ㅇㅣㄹㄹㅣㅇㅣㅊㅣ
churandy	ㅊㅜㄹㅏㄴㄷㅣ
laube	ㄹㅏㅇㅜㅂㅣ
pillud	ㅍㅣㅇㅠㄷㅡ
tarkan	ㅌㅏㄹㅡㅋㅏㄴ
peltre	ㅍㅐㄹㅌㅡㄹㅡ
gabbidon	ㄱㅏㅂㅣㄷㅓㄴ
malala	ㅁㅏㄹㄹㅏㄹㄹㅏ
pawlak	ㅍㅏㅂㅡㄹㄹㅏㅋㅡ
cremonte	ㅋㅡㄹㅔㅁㅗㄴㅌㅔ
kozyr	ㅋㅗㅈㅣㄹㅡ
brass	ㅂㅡㄹㅏㅅㅡ
marcilloux	ㅁㅏㄹㅡㅅㅣㄹㄹㅜ
fortune	ㅍㅗㅊㅜㄴ
orla	ㅇㅗㄹㄹㅏ
braque	ㅂㅡㄹㅏㅋㅡ
bouvie	ㅂㅗㅂㅣㅇㅔ
alzamendi	ㅇㅏㄹㅅㅏㅁㅔㄴㄷㅣ
dossena	ㄷㅗㅅㅔㄴㅏ
mwangi	ㅁㅡㅇㅘㄴㅈㅣ
welling	ㅇㅞㄹㄹㅣㅇ
isgrove	ㅇㅣㅈㅡㄱㅡㄹㅗㅂㅡ
milnor	ㅁㅣㄹㄴㅓ
mcloughlin	ㅁㅐㅋㅡㄹㄹㅗㅍㅡㄹㄹㅣㄴ
mcgavran	ㅁㅐㄱㄱㅏㅂㅡㄹㅏㄴ
bonev	ㅂㅗㄴㅔㅍㅡ
talvela	ㅌㅏㄹㅂㅔㄹㄹㅏ
romy	ㄹㅗㅁㅣ
bouzaid	ㅂㅜㅈㅏㅇㅣㄷㅡ
burdisso	ㅂㅜㄹㅡㄷㅣㅅㅗ
ventham	ㅂㅔㄴㄷㅏㅁ
nobufuru	ㄴㅗㅂㅜㅎㅜㄹㅜ
cliffe	ㅋㅡㄹㄹㅣㅍㅡ
gygax	ㄱㅣㄱㅏㄱㅅㅡ
kirstin	ㅋㅓㅅㅡㅌㅣㄴ
chikanaga	ㅈㅣㅋㅏㄴㅏㄱㅏ
alfonsas	ㅇㅏㄹㅍㅗㄴㅅㅏㅅㅡ
cassou	ㅋㅏㅅㅜ
alistair	ㅇㅏㄹㄹㅣㅅㅡㅌㅓ
zicu	ㅈㅣㅋㅜ
smet	ㅅㅡㅁㅔㅌㅡ
arreaza	ㅇㅏㄹㅔㅇㅏㅅㅏ
rapaport	ㄹㅏㅍㅏㅍㅗㄹㅡㅌㅡ
halkina	ㅎㅏㄹㅋㅣㄴㅏ
voznesensky	ㅂㅗㅈㅡㄴㅔㅅㅔㄴㅅㅡㅋㅣ
soulscape	ㅅㅗㅇㅜㄹㅅㅡㅋㅔㅇㅣㅍㅡ
boulding	ㅂㅗㄹㄷㅣㅇ
joselu	ㅎㅗㅅㅔㄹㄹㅜ
gottheimer	ㄱㅗㅅㅎㅏㅇㅣㅁㅓ
milioti	ㅁㅣㄹㄹㅣㅇㅗㅌㅣ
antonique	ㅇㅐㄴㅌㅗㄴㅣㅋㅡ
duboscq	ㄷㅟㅂㅗㅅㅡㅋㅡ
baburin	ㅂㅏㅂㅜㄹㅣㄴ
anfisa	ㅇㅏㄴㅍㅣㅅㅏ
caminero	ㅋㅏㅁㅣㄴㅔㄹㅗ
nhlanhla	ㅇㅡㄴㄹㅏㄴㄹㅏ
diskerud	ㄷㅣㅅㅡㅋㅔㄹㅜㅌㅡ
pattison	ㅍㅐㅌㅣㅅㅡㄴ
dinesen	ㄷㅣㄴㅔㅅㅔㄴ
garbocz	ㄱㅏㄹㅡㅂㅗㅊㅣ
gerardus	ㄱㅔㄹㅏㄹㅡㄷㅜㅅㅡ
manville	ㅁㅐㄴㅂㅣㄹ
geddes	ㄱㅔㄷㅣㅅㅡ
goffin	ㄱㅗㅍㅣㄴ
hatzius	ㅎㅏㅊㅣㅇㅜㅅㅡ
rostom	ㄹㅗㅅㅡㅌㅗㅁ
guinness	ㄱㅣㄴㅣㅅㅡ
verrazzano	ㅂㅔㄹㅏㅊㅏㄴㅗ
djibo	ㅈㅣㅂㅗ
grench	ㄱㅡㄹㅔㄴㅊㅣ
retton	ㄹㅔㅌㅓㄴ
bersani	ㅂㅔㄹㅡㅅㅏㄴㅣ
goodricke	ㄱㅜㄷㅡㄹㅣㅋㅔ
yanka	ㅇㅑㅇㅋㅏ
naidu	ㄴㅏㅇㅣㄷㅜ
cambor	ㅋㅐㅁㅂㅓ
cikra	ㅅㅣㅋㅡㄹㅏ
gonji	ㄱㅗㄴㅈㅣ
baxendale	ㅂㅐㄱㅅㅡㄴㄷㅔㅇㅣㄹ
hochhuth	ㅎㅗㅎㅡㅎㅜㅌㅡ
rader	ㄹㅔㅇㅣㄷㅓ
blasis	ㅂㅡㄹㄹㅏㅅㅣㅅㅡ
biddell	ㅂㅣㄷㅔㄹ
dmitriev	ㄷㅡㅁㅣㅌㅡㄹㅣㅇㅖㅍㅡ
pinchot	ㅍㅣㄴㅊㅗㅅ
francischini	ㅍㅡㄹㅏㄴㅅㅣㅅㅡㅅㅣㄴㅣ
sula	ㅅㅜㄹㄹㅏ
tanay	ㅌㅏㄴㅏㅇㅣ
niven	ㄴㅣㅂㅡㄴ
gaiman	ㄱㅔㅇㅣㅁㅓㄴ
hoad	ㅎㅗㄷㅡ
muhammetkaliy	ㅁㅜㅎㅏㅁㅁㅔㅅㅋㅏㄹㄹㅣ
selahattin	ㅅㅔㄹㄹㅏㅎㅏㅌㅣㄴ
talpade	ㅌㅏㄹㅍㅏㄷㅡ
rosana	ㄹㅗㅅㅏㄴㅏ
mbia	ㅇㅡㅁㅂㅣㅇㅏ
turness	ㅌㅓㄴㅔㅅㅡ
iero	ㅇㅏㅇㅣㅇㅔㄹㅗ
benben	ㅂㅔㄴㅂㅔㄴ
kakas	ㅋㅓㅋㅓㅅㅣ
bertoldo	ㅂㅔㄹㅡㅌㅗㄹㄷㅜ
yobo	ㅇㅛㅂㅗ
lukashenko	ㄹㅜㅋㅏㅅㅖㄴㅋㅗ
ayano	ㄱㅗ
tiselius	ㅌㅣㅅㅔㄹㄹㅣㅇㅜㅅㅡ
perova	ㅍㅔㄹㅗㅂㅏ
yusra	ㅇㅠㅅㅡㄹㅏ
ashely	ㅇㅐㅅㅟㄹㄹㅣ
streep	ㅅㅡㅌㅡㄹㅣㅂ
handy	ㅎㅐㄴㄷㅣ
gaykhatu	ㄱㅏㅇㅣㅎㅏㅌㅜ
allix	ㅇㅏㄹㄹㅣㄱㅅㅡ
petrosian	ㅍㅔㅌㅡㄹㅗㅅㅑㄴ
verbytsky	ㅂㅔㄹㅡㅂㅣㅊㅡㅋㅣ
orbaiz	ㅇㅗㄹㅡㅂㅏㅇㅣㅅㅡ
bellissimo	ㅍㅡㄹㅏㄴㅊㅔㅅㅡㅋㅗ
stendardo	ㅅㅡㅌㅔㄴㄷㅏㄹㅡㄷㅗ
fedoriva	ㅍㅔㄷㅗㄹㅣㅂㅏ
barna	ㅂㅏㄹㅡㄴㅏ
parejo	ㅍㅏㄹㅔㅎㅗ
natsuko	ㄴㅏㅆㅡㅋㅗ
harrelson	ㅎㅐㄹㅓㄹㅅㅡㄴ
korzhanenko	ㅋㅗㄹㅡㅈㅏㄴㅔㄴㅋㅗ
vanier	ㅂㅏㄴㅣㅇㅔㄹㅡ
mierzejewski	ㅁㅣㅇㅔㄹㅡㅈㅔㅇㅖㅍㅡㅅㅡㅋㅣ
mamun	ㅁㅏㅁㅜㄴ
dinkins	ㄷㅣㄴㅋㅣㄴㅅㅡ
chikuzan	ㅈㅣㅋㅜㅈㅏㄴ
gainsborough	ㄱㅔㅇㅣㄴㅈㅡㅂㅓㄹㅓ
nobunao	ㄴㅗㅂㅜㄴㅏㅇㅗ
macbeth	ㅁㅐㄱㅂㅔㅅㅡ
hisatomi	ㄱㅔㄴ
heim	ㅎㅏㅇㅣㅁ
ryn	ㄹㅣㄴ
stuhlbarg	ㅅㅡㅌㅓㄹㅂㅓㄱㅡ
kiara	ㅋㅣㅇㅏㄹㅏ
meiyuan	ㅁㅔㅇㅣㅇㅠㅇㅏㄴ
seibert	ㅅㅔㅇㅣㅂㅓㅌㅡ
tyrone	ㅌㅣㄹㅗㄴㅓ
slavkov	ㅅㅡㄹㄹㅏㅂㅡㅋㅗㅍㅡ
lansdown	ㄹㅐㄴㅅㅡㄷㅏㅇㅜㄴ
alpay	ㅇㅏㄹㅍㅏㅇㅣ
girault	ㅈㅣㄹㅗ
macedonicus	ㅁㅏㅋㅔㄷㅗㄴㅣㅋㅜㅅㅡ
zorc	ㅊㅗㅇㅓㅋㅡ
shimasaki	ㅇㅠ
mahdi	ㅁㅏㅎㅡㄷㅣ
kalong	ㅋㅏㄹㄹㅗㅇ
cavallari	ㅋㅐㅂㅐㄹㄹㅓㄹㅣ
saburo	ㅋㅏㅇㅘㅂㅜㅊㅣ
rugland	ㄹㅓㄱㅡㄹㄹㅏㄴㄷㅡ
tora	ㅌㅗㄹㅏ
kimmy	ㅋㅣㅁㅣ
trank	ㅌㅡㄹㅐㅇㅋㅡ
bacary	ㅂㅏㅋㅏㄹㅣ
negrini	ㄴㅔㄱㅡㄹㅣㄴㅣ
laclos	ㄹㅏㅋㅡㄹㄹㅗ
wallach	ㅂㅏㄹㄹㅏㅎㅡ
nicias	ㄴㅣㅋㅣㅇㅏㅅㅡ
jaeden	ㅈㅔㅇㅣㄷㅡㄴ
barat	ㅂㅏㄹㅏㅅ
darlington	ㄷㅏㄹㄹㅣㅇㅌㅓㄴ
jahan	ㅈㅏㅎㅏㄴ
anicio	ㅇㅏㄴㅣㅅㅣㅇㅜ
pulisic	ㅍㅜㄹㄹㅣㅅㅣㅊㅣ
cunanan	ㅋㅓㄴㅐㄴㅓㄴ
zubin	ㅈㅜㅂㅣㄴ
supreme	ㅅㅠㅍㅡㄹㅣㅁ
natterson	ㄴㅔㅌㅓㅅㅡㄴ
tielemans	ㅌㅣㄹㄹㅔㅁㅏㄴㅅㅡ
ligdan	ㄹㅣㅇㄷㅏㄴ
pilkington	ㅍㅣㄹㅋㅣㅇㅌㅓㄴ
cicely	ㅅㅏㅇㅣㅅㅡㄹㄹㅣ
vujicic	ㅂㅜㅇㅣㅊㅣㅊㅡ
bacewicz	ㅂㅏㅊㅔㅂㅣㅊㅣ
govi	ㄱㅗㅂㅣ
liouville	ㄹㅣㅇㅜㅂㅣㄹ
hatchi	ㅎㅏㅊㅣ
valberg	ㅂㅏㄹㅂㅔㄹㅣ
garrit	ㄱㅏㅎㅣㅌㅡ
sidorova	ㅅㅣㄷㅗㄹㅗㅂㅏ
boscono	ㅂㅗㅅㅡㅋㅗㄴㅗ
sedykh	ㅅㅔㄷㅣㅎㅡ
ziskin	ㅈㅣㅅㅡㅋㅣㄴ
beno	ㅂㅔㄴㅗ
komova	ㅋㅗㅁㅗㅂㅏ
melton	ㅁㅔㄹㅌㅡㄴ
ototake	ㅎㅣㄹㅗㅌㅏㄷㅏ
sherrill	ㅅㅖㄹㅣㄹ
podshivalov	ㅍㅗㄷㅡㅅㅣㅂㅏㄹㄹㅗㅍㅡ
loverdos	ㄹㅗㅂㅔㄹㅡㄷㅗㅅㅡ
sacagawea	ㅅㅐㅋㅓㄱㅓㅇㅟㅇㅏ
sizemore	ㅅㅣㅈㅡㅁㅗㅇㅓ
toshifumi	ㅂㅏㅂㅏ
bracigliano	ㅂㅡㄹㅏㅊㅣㄹㄹㅣㅇㅏㄴㅗ
anastas	ㅇㅏㄴㅏㅅㅡㅌㅏㅅㅡ
stump	ㅅㅡㅌㅓㅁㅍㅡ
larroca	ㄹㅏㄹㅗㅋㅏ
jeffree	ㅈㅔㅍㅡㄹㅣ
tami	ㅌㅏㅁㅣ
schoonmaker	ㅅㅡㅋㅜㄴㅁㅔㅇㅣㅋㅓ
yayo	ㅇㅑㅇㅛ
shimoji	ㅅㅛ
ziana	ㅈㅣㅇㅏㄴㅏ
finnigan	ㅍㅣㄴㅣㄱㅓㄴ
corsten	ㅋㅗㅅㅡㅌㅓㄴ
kawaragi	ㅅㅣㅎㅗ
arlenis	ㅇㅏㄹㅡㄹㄹㅔㄴㅣㅅㅡ
favela	ㅍㅏㅂㅔㄹㄹㅏ
jacquard	ㅈㅏㅋㅏㄷㅡ
chasey	ㅊㅔㅇㅣㅅㅣ
debussy	ㄷㅡㅂㅟㅅㅣ
nikephoros	ㄴㅣㅋㅔㅍㅗㄹㅜㅅㅡ
necker	ㄴㅔㅋㅔㄹㅡ
humayun	ㅎㅜㅁㅏㅇㅠㄴ
klay	ㅋㅡㄹㄹㅔㅇㅣ
hafsia	ㅎㅏㅍㅡㅅㅣㅇㅏ
nariatsu	ㄴㅏㄹㅣㅇㅏㅆㅡ
ochirbat	ㅇㅗㅊㅣㄹㅡㅂㅏㅌㅡ
weintraub	ㅇㅘㅇㅣㄴㅌㅡㄹㅏㅇㅜㅂㅡ
winborne	ㅇㅟㄴㅂㅗㄴ
edberg	ㅇㅔㄷㅡㅂㅔㄹㅣ
kabananga	ㅋㅏㅂㅏㄴㅏㅇㄱㅏ
freydoun	ㅍㅡㄹㅔㅇㅣㄷㅜㄴ
honeybone	ㅎㅓㄴㅣㅂㅗㄴ
karapet	ㅋㅏㄹㅏㅍㅔㅅ
urszula	ㅇㅜㄹㅡㅅㅠㄹㄹㅏ
immanuel	ㅇㅣㅁㅏㄴㅜㅇㅔㄹ
zabryna	ㅈㅏㅂㅡㄹㅣㄴㅏ
nadella	ㄴㅏㄷㅔㄹㄹㅏ
konoplyanka	ㅋㅗㄴㅗㅍㅡㄹㄹㅑㄴㅋㅏ
gilels	ㄱㅣㄹㄹㅔㄹㅅㅡ
latrell	ㄹㅏㅌㅡㄹㅔㄹ
rendell	ㄹㅔㄴㄷㅔㄹ
bonsels	ㅂㅗㄴㅈㅔㄹㅅㅡ
abdulkader	ㅇㅏㅂㄷㅜㄹㅋㅏㄷㅔㄹㅡ
izzah	ㅇㅣㅈㅏㅎㅡ
besco	ㅂㅔㅅㅡㅋㅗ
michetti	ㅁㅣㅋㅔㅌㅣ
harumoto	ㅎㅏㄹㅜㅁㅗㅌㅗ
yaowapa	ㅇㅑㅇㅗㅇㅘㅍㅏ
tetzner	ㅌㅔㅊㅡㄴㅓ
hitchens	ㅎㅣㅊㅣㄴㅅㅡ
nani	ㄴㅏㄴㅣ
pata	ㅍㅏㅌㅏ
mvusi	ㅇㅡㅁㅂㅜㅅㅣ
vesalius	ㅂㅔㅅㅏㄹㄹㅣㅇㅜㅅㅡ
okounkov	ㅇㅗㅋㅜㄴㅋㅗㅍㅡ
illeana	ㅇㅣㄹㄹㅣㄴㅏ
maurus	ㅁㅏㅇㅜㄹㅜㅅㅡ
fulop	ㅍㅜㄹㄹㅗㅂ
nagakuni	ㄴㅏㄱㅏㅋㅜㄴㅣ
nere	ㄴㅔㄹㅔ
carnelian	ㅋㅏㄴㅔㄹㄹㅣㅇㅏㄴ
velupillai	ㅂㅔㄹㄹㅜㅍㅣㄹㄹㅏㅇㅣ
rybkin	ㄹㅣㅂㅋㅣㄴ
ebilun	ㅇㅏㄹㅍㅣㄹㄹㅠㅇ
kimiyasu	ㄱㅜㄷㅗ
steller	ㅅㅠㅌㅔㄹㄹㅓ
slaughter	ㅅㅡㄹㄹㅗㅌㅓ
nizar	ㄴㅣㅈㅏㄹㅡ
kobe	ㅋㅗㅂㅣ
padukone	ㅍㅏㄷㅜㅋㅗㄴ
alfre	ㅇㅏㄹㅍㅡㄹㅔ
sigrun	ㅈㅣㄱㅡㄹㅜㄴ
higuita	ㅇㅣㄱㅣㅌㅏ
bergqvist	ㅂㅔㄹㅣㅋㅡㅂㅣㅅㅡㅌㅡ
missillier	ㅁㅣㅅㅣㄹㄹㅣㅇㅔ
yukana	ㅇㅠㅋㅏㄴㅏ
mccutchen	ㅁㅐㄱㅋㅓㅊㅣㄴ
cush	ㅋㅜㅅㅣ
schumaker	ㅅㅠㅁㅏㅋㅓ
kublai	ㅋㅜㅂㅣㄹㄹㅏㅇㅣ
drago	ㄷㅡㄹㅐㄱㅗ
notary	ㄴㅗㅌㅓㄹㅣ
nono	ㄴㅗㄴㅗ
matadi	ㅁㅏㅌㅏㄷㅣ
punto	ㅍㅜㄴㅌㅗ
demoustier	ㄷㅡㅁㅜㅅㅡㅌㅣㅇㅔ
borriello	ㅂㅗㄹㅣㅇㅔㄹㄹㅗ
salmaan	ㅅㅏㄹㅁㅏㄴ
debreu	ㄷㅡㅂㅡㄹㅚ
twist	ㅌㅡㅇㅟㅅㅡㅌㅡ
sultonov	ㅅㅜㄹㅌㅗㄴㅗㅍㅡ
shattiwaza	ㅅㅏㅌㅣㅇㅘㅈㅏ
padoan	ㅍㅏㄷㅗㅇㅏㄴ
aetius	ㅇㅏㅇㅔㅌㅣㅇㅜㅅㅡ
bhaichung	ㅂㅏㅇㅣㅊㅜㅇ
aurelian	ㅇㅏㅇㅜㄹㅔㄹㄹㅣㅇㅏㄴㅜㅅㅡ
aleko	ㅇㅏㄹㄹㅔㅋㅗ
coquerel	ㅋㅗㅋㅡㄹㅔㄹ
nishiki	ㄴㅣㅅㅣㅋㅣ
orwell	ㅇㅗㅇㅞㄹ
amanpour	ㅇㅏㅁㅏㄴㅍㅗ
roch	ㄹㅗㅎㅡ
alekperov	ㅇㅏㄹㄹㅔㄱㅍㅔㄹㅗㅍㅡ
solohub	ㅅㅗㄹㄹㅗㅎㅜㅂㅡ
kristi	ㅋㅡㄹㅣㅅㅡㅌㅣ
ruzena	ㄹㅜㅈㅔㄴㅏ
siti	ㅅㅣㅌㅣ
dhillon	ㄷㅣㄹㄹㅗㄴ
libman	ㄹㅣㅂㅡㅁㅓㄴ
kishioku	ㅇㅠㅈㅣ
theyab	ㅌㅔㅇㅑㅂㅡ
hendershott	ㅎㅔㄴㄷㅓㅅㅛㅅ
freimuth	ㅍㅡㄹㅏㅇㅣㅁㅜㅌㅡ
bogd	ㅂㅗㄱㄷㅡ
thulasiraj	ㅌㅜㄹㄹㅏㅅㅣㄹㅏㅈㅡ
dewatripont	ㄷㅔㅂㅏㅌㅡㄹㅣㅍㅗㄴㅌㅡ
vergoossen	ㅍㅔㄹㅡㅎㅗㅅㅓㄴ
tituss	ㅌㅏㅇㅣㅌㅓㅅㅡ
barnaby	ㅂㅏㄴㅓㅂㅣ
soboul	ㅅㅗㅂㅜㅇㅜㄹ
shenkman	ㅅㅒㅇㅋㅡㅁㅓㄴ
dehn	ㄷㅔㄴ
rawat	ㄹㅏㅇㅘㅅ
munetoshi	ㅁㅜㄴㅔㅌㅗㅅㅣ
rijkaard	ㄹㅔㅇㅣㅋㅏㄹㅡㅌㅡ
jovanovski	ㅈㅗㅂㅓㄴㅗㅂㅡㅅㅡㅋㅣ
sinoussi	ㅅㅣㄴㅜㅅㅡ
brazza	ㅂㅡㄹㅏㅈㅏ
peri	ㅍㅔㄹㅣ
hadfield	ㅎㅐㄷㅡㅍㅣㄹㄷㅡ
nalo	ㄴㅏㄹㄹㅗ
vandross	ㅂㅐㄴㄷㅡㄹㅗㅅㅡ
dhorasoo	ㄷㅗㄹㅏㅅㅗ
kagasoff	ㅋㅐㄱㅓㅅㅗㅍㅡ
hideharu	ㅎㅣㄷㅔㅎㅏㄹㅜ
herzl	ㅎㅔㄹㅡㅊㅡㄹ
obadele	ㅇㅗㅂㅏㄷㅔㄹㄹㅔ
shigekatsu	ㅅㅣㄱㅔㅋㅏㅆㅡ
ujimasa	ㅇㅜㅈㅣㅁㅏㅅㅏ
avitus	ㅇㅏㅂㅣㅌㅜㅅㅡ
merna	ㅁㅔㄹㅡㄴㅏ
chobin	ㅋㅗㅂㅣㄴ
ruffini	ㄹㅜㅍㅣㄴㅣ
bjerre	ㅂㅣㅇㅔㄹㅔ
doukas	ㄷㅜㅋㅏㅅㅡ
christien	ㅋㅡㄹㅣㅅㅡㅌㅣㄴ
sladen	ㅅㅡㄹㄹㅔㅇㅣㄷㅡㄴ
frantz	ㅍㅡㄹㅏㄴㅊㅡ
panton	ㅍㅐㄴㅌㅗㄴ
harington	ㅎㅐㄹㅣㅇㅌㅓㄴ
lashkhi	ㄹㅏㅅㅠㅎㅣ
futerman	ㅍㅜㅌㅓㅁㅓㄴ
iscariot	ㅇㅠㄷㅏ
mateelong	ㅁㅏㅌㅔㄹㄹㅗㅇ
damilano	ㄷㅏㅁㅣㄹㄹㅏㄴㅗ
muercoles	ㅁㅏㅊㅏㄷㅗ
overstreet	ㅇㅗㅂㅓㅅㅡㅌㅡㄹㅣㅌㅡ
earhart	ㅇㅔㅇㅓㅎㅏㅌㅡ
tankersley	ㅌㅐㅇㅋㅓㅅㅡㄹㄹㅣ
hoobler	ㅎㅜㅂㅡㄹㄹㅓ
meola	ㅁㅣㅇㅗㄹㄹㅏ
mcleod	ㅁㅐㄱㄹㅓㄷㅡ
melitta	ㅁㅣㄹㄹㅣㅌㅏ
theaetetus	ㅌㅔㅇㅏㅇㅣㅌㅔㅌㅗㅅㅡ
clausen	ㅋㅡㄹㄹㅏㅇㅜㅅㅔㄴ
loubna	ㄹㅜㅂㅡㄴㅏ
huhtanen	ㅎㅜㅌㅏㄴㅔㄴ
chazapis	ㅎㅏㅈㅏㅍㅣㅅㅡ
petrick	ㅍㅐㅌㅡㄹㅣㄱ
aickman	ㅇㅔㅇㅣㅋㅡㅁㅓㄴ
honecker	ㅎㅗㄴㅔㅋㅓ
pawlik	ㅍㅏㅂㅡㄹㄹㅣㅋㅡ
messe	ㅁㅔㅅㅔ
kolo	ㅋㅗㄹㄹㅗ
loken	ㄹㅗㅋㅓㄴ
sulley	ㅅㅓㄹㄹㅣ
jorgie	ㅈㅗㅈㅣ
fin	ㅍㅣㄴ
diora	ㄷㅣㅇㅗㄹㅏ
abalakov	ㅇㅏㅂㅏㄹㄹㅏㅋㅗㅍㅡ
galmarini	ㄱㅏㄹㅁㅏㄹㅣㄴㅣ
gerber	ㄱㅔㅇㅓㅂㅓ
shikauchi	ㅌㅏㅋㅏㅅㅣ
viveka	ㅂㅣㅂㅔㅋㅏ
macgregor	ㅁㅐㄱㄱㅡㄹㅣㄱㅓ
tuta	ㅌㅜㅌㅏ
capriles	ㅋㅏㅍㅡㄹㅣㄹㄹㅔㅅㅡ
djamal	ㅈㅏㅁㅏㄹ
szymborska	ㅅㅣㅁㅂㅗㄹㅡㅅㅡㅋㅏ
blasetti	ㅂㅡㄹㄹㅏㅅㅔㅌㅣ
nistelrooy	ㄴㅣㅅㅡㅌㅔㄹㄹㅗㅇㅣ
kurchatov	ㅋㅜㄹㅡㅊㅏㅌㅗㅍㅡ
rigi	ㄹㅣㄱㅣ
gondrin	ㄱㅗㅇㄷㅡㄹㅔㅇ
abdeslam	ㅇㅏㅂㄷㅔㅅㅡㄹㄹㅏㅁ
macchio	ㅁㅏㅊㅣㅇㅗ
hitzlsperger	ㅎㅣㅊㅡㄹㅅㅠㅍㅔㄹㅡㄱㅓ
aiello	ㅇㅏㅇㅔㄹㄹㅗ
aquilino	ㅇㅏㅋㅣㄹㄹㅣㄴㅗ
khayr	ㅎㅏㅇㅣㄹㅡ
resnik	ㄹㅔㅅㅡㄴㅣㄱ
pento	ㅍㅔㄴㅌㅗ
gunz	ㄱㅓㄴㅈㅡ
hipasus	ㅎㅣㅍㅏㅅㅗㅅㅡ
heuss	ㅎㅗㅇㅣㅅㅡ
pako	ㅍㅏㅋㅗ
huckabee	ㅎㅓㅋㅓㅂㅣ
nery	ㄴㅔㄹㅣ
alleyne	ㅇㅐㄹㄹㅓㄴ
lomakin	ㄹㅗㅁㅏㅋㅣㄴ
haavik	ㅎㅗㅂㅣㅋㅡ
garang	ㄱㅏㄹㅏㅇ
karyuchenko	ㅋㅏㄹㅠㅊㅔㄴㅋㅗ
anastasiou	ㅇㅏㄴㅏㅅㅡㅌㅏㅅㅣㅇㅜ
chantelle	ㅅㅑㄴㅌㅔㄹ
carnes	ㅋㅏㄴㅅㅡ
dombasle	ㄷㅗㅇㅂㅏㅅㅡㄹ
massadio	ㅁㅏㅅㅏㄷㅣㅇㅗ
kajol	ㅋㅏㅈㅗㄹ
klemperer	ㅋㅡㄹㄹㅔㅁㅍㅓㄹㅓ
teruyuki	ㄴㅗㅂㅜㅊㅣㅋㅏ
mcgann	ㅁㅐㄱㄱㅐㄴ
rut	ㄹㅜㅌㅡ
ntaryamira	ㅇㅡㄴㅌㅏㄹㅑㅁㅣㄹㅏ
hirobumi	ㅎㅣㄹㅗㅂㅜㅁㅣ
radmilo	ㄹㅏㄷㅡㅁㅣㄹㄹㅗ
juhar	ㅈㅜㅎㅏㄹㅡ
gammala	ㅋㅏㅁㅏㄹㄹㅏ
jeroboam	ㅇㅕㄹㅗㅂㅗㅇㅏㅁ
golikova	ㄱㅗㄹㄹㅣㅋㅗㅂㅏ
shigeie	ㄷㅗㅅㅣㄴㅗㄹㅣ
bedos	ㅂㅔㄷㅗㅅㅡ
ahna	ㅇㅏㄴㅏ
varane	ㅂㅏㄹㅏㄴ
confalonieri	ㅋㅗㄴㅍㅏㄹㄹㅗㄴㅣㅇㅔㄹㅣ
ricchiuti	ㄹㅣㄱㅊㅣㅇㅜㅌㅣ
pire	ㅍㅣㄹㅡ
diskin	ㄷㅣㅅㅡㅋㅣㄴ
burim	ㅂㅜㄹㅣㅁ
linchuk	ㄹㅣㄴㅊㅜㅋㅡ
noreena	ㄴㅗㄹㅣㄴㅏ
mongo	ㅁㅗㅇㄱㅗ
jannetty	ㅈㅐㄴㅔㅌㅣ
ditama	ㅂㅗ
daylight	ㄷㅔㅇㅣㄹㅏㅇㅣㅌㅡ
beccalossi	ㅂㅔㅋㅏㄹㄹㅗㅅㅣ
tinie	ㅌㅏㅇㅣㄴㅣ
elliphant	ㅇㅔㄹㄹㅣㅍㅐㄴㅌㅡ
ingman	ㅇㅣㅇㄱㅡㅁㅏㄴ
bunei	ㅂㅜㄴㅔㅇㅣ
parvin	ㅍㅏㄹㅡㅂㅣㄴ
dlo	ㄷㅣㄹㄹㅗ
simonds	ㅅㅣㅁㅓㄴㅈㅡ
nomenjanahary	ㄴㅗㅁㅔㅈㅏㄴㅏㅎㅏㄹㅣ
malafeev	ㅁㅏㄹㄹㅏㅍㅔㅇㅖㅍㅡ
titova	ㅌㅣㅌㅗㅂㅏ
larrey	ㄹㅏㄹㅔ
francesc	ㅍㅡㄹㅏㄴㅅㅣㅅㅡㅋㅗ
oakes	ㅇㅗㅋㅡㅅㅡ
eloranta	ㅇㅔㄹㄹㅗㄹㅏㄴㅌㅏ
maila	ㅁㅏㅇㅣㄹㄹㅏ
featherston	ㅍㅔㄷㅓㅅㅡㅌㅓㄴ
defar	ㄷㅔㅍㅏㄹㅡ
turtle	ㅌㅓㅌㅡㄹ
coria	ㅋㅗㄹㅣㅇㅏ
guiomar	ㄱㅣㅇㅗㅁㅏㄹㅡ
felipinho	ㅍㅔㄹㄹㅣㅍㅣㄴㅠ
adamo	ㅇㅏㄷㅏㅁㅗ
kaling	ㅋㅐㄹㄹㅣㅇ
shemyakina	ㅅㅖㅁㅇㅑㅋㅣㄴㅏ
reichs	ㄹㅏㅇㅣㅋㅡㅅㅡ
baumjohann	ㅂㅏㅇㅜㅁㅇㅛㅎㅏㄴ
tallis	ㅌㅐㄹㄹㅣㅅㅡ
beenzino	ㅂㅣㄴㅈㅣㄴㅗ
stroustrup	ㅅㅡㅌㅡㄹㅗㅂㅅㅡㅌㅡㄹㅜㅂ
cunmulaj	ㅊㅜㄴㅁㅜㄹㄹㅏㅇㅣ
titian	ㅌㅣㅊㅣㅇㅏㄴㅗ
abedi	ㅇㅏㅂㅔㄷㅣ
riza	ㄹㅣㅈㅏ
chazal	ㅅㅑㅈㅏㄹ
neaga	ㄴㅔㅇㅏㄱㅏ
backes	ㅂㅐㅋㅣㅅㅡ
sashihara	ㄹㅣㄴㅗ
saez	ㅅㅏㅇㅔㅈㅡ
fanfani	ㅍㅏㄴㅍㅏㄴㅣ
aneurin	ㅇㅏㄴㅠㄹㅣㄴ
groot	ㅎㅡㄹㅗㅌㅡ
aurier	ㅇㅗㄹㅣㅇㅔ
ademeit	ㅇㅏㄷㅔㅁㅏㅇㅣㅌㅡ
canedo	ㅋㅏㄴㅔㄷㅜ
gnabry	ㄴㅑㅂㅡㄹㅣ
avramopoulos	ㅇㅏㅂㅡㄹㅏㅁㅗㅍㅜㄹㄹㅗㅅㅡ
tilton	ㅌㅣㄹㅌㅓㄴ
hals	ㅎㅏㄹㅅㅡ
afshar	ㅇㅏㅍㅡㅅㅑㄹㅡ
okimasa	ㅇㅗㅋㅣㅁㅏㅅㅏ
shigemura	ㅅㅣㄱㅔㅁㅜㄹㅏ
ilayda	ㅇㅣㄹㄹㅏㅇㅣㄷㅏ
rosell	ㄹㅗㅅㅔㄹ
waggoner	ㅇㅙㄱㅓㄴㅓ
windisch	ㅂㅣㄴㄷㅣㅅㅠ
kimeli	ㅋㅣㅁㅔㄹㄹㅣ
tansman	ㅌㅏㄴㅅㅡㅁㅏㄴ
belinda	ㅂㅔㄹㄹㅣㄴㄷㅏ
babbel	ㅂㅏㅂㅔㄹ
shantideva	ㅅㅑㄴㅌㅣㄷㅔㅂㅏ
swanepoel	ㅅㅡㅇㅝㄴㅓㅍㅜㄹ
dohring	ㄷㅗㄹㅣㅇ
cammarelle	ㅋㅏㅁㅁㅏㄹㅔㄹㄹㅔ
abeid	ㅇㅏㅂㅔㅇㅣㄷㅡ
whittle	ㅎㅟㅌㅡㄹ
sternberg	ㅅㅠㅌㅔㄹㅡㄴㅂㅔㄹㅡㅋㅡ
wingert	ㅇㅟㅇㄱㅓㅌㅡ
craucher	ㅋㅡㄹㅏㅇㅜㅎㅓ
vejsupaporn	ㅇㅞㅊㅜㅍㅏㅍㅗㄴ
mcdavid	ㅁㅐㄱㄷㅔㅇㅣㅂㅣㄷㅡ
shamriz	ㅅㅑㅁㄹㅣㅈㅡ
kassy	ㅋㅔㅇㅣㅅㅣ
lizzani	ㄹㅣㅊㅏㄴㅣ
bayes	ㅂㅔㅇㅣㅈㅡ
durst	ㄷㅓㅅㅡㅌㅡ
toews	ㅌㅔㅇㅣㅂㅡㅅㅡ
nobukane	ㄴㅗㅂㅜㅋㅏㄴㅔ
pritchard	ㅍㅡㄹㅣㅅㅅㅑㄹㅡㄷㅡ
teia	ㅌㅔㅇㅣㅇㅏ
taufatofua	ㅌㅏㅇㅜㅍㅏㅌㅗㅍㅜㅇㅏ
eilers	ㅇㅏㅇㅣㄹㄹㅓㅅㅡ
ramzan	ㄹㅏㅁㅈㅏㄴ
vital	ㅂㅣㅌㅏㄹ
moubandje	ㅁㅜㅂㅏㅇㅈㅔ
jezel	ㅈㅣㅈㅔㄹ
anastasov	ㅇㅏㄴㅏㅅㅡㅌㅏㅅㅗㅍㅡ
pederson	ㅍㅣㄷㅓㅅㅡㄴ
pigafetta	ㅍㅣㄱㅏㅍㅔㅌㅏ
danshoku	ㄷㅏㄴㅅㅛㅋㅜ
kusturica	ㅋㅜㅅㅡㅌㅜㄹㅣㅊㅏ
schiaffino	ㅅㅡㅊㅣㅇㅏㅍㅣㄴㅗ
veltroni	ㅂㅔㄹㅌㅡㄹㅗㄴㅣ
orphanidis	ㅇㅗㄹㅡㅍㅏㄴㅣㄷㅣㅅㅡ
ekei	ㅇㅔㅋㅔㅇㅣ
bilzerian	ㅂㅣㄹㅈㅓㄹㅣㅇㅓㄴ
riria	ㄹㅣㄹㅣㅇㅏ
bossut	ㅂㅗㅅㅟ
bould	ㅂㅗㄹㄷㅡ
sakisaka	ㅇㅣㅇㅗ
ardizoglou	ㅇㅏㄹㅡㄷㅣㅈㅗㄱㅡㄹㄹㅜ
poland	ㅍㅗㄹㄹㅏㄴㄷㅡ
thouvenin	ㅌㅜㅂㅔㄴㅐㅇ
vivi	ㅂㅣㅂㅣ
gardot	ㄱㅏㄹㅡㄷㅗㅌㅡ
althusius	ㅇㅏㄹㅌㅜㅈㅣㅇㅜㅅㅡ
corwin	ㅋㅗㅇㅟㄴ
meitner	ㅁㅏㅇㅣㅌㅡㄴㅓ
peithon	ㅍㅔㅇㅣㅌㅗㄴ
fonsi	ㅍㅗㄴㅅㅣ
cera	ㅅㅔㄹㅏ
aleinikov	ㅇㅏㄹㄹㅔㅇㅣㄴㅣㅋㅗㅍㅡ
peebles	ㅍㅣㅂㅡㄹㅅㅡ
akhmatkhuzin	ㅇㅏㅋㅡㅁㅏㅌㅡㅋㅜㅈㅣㄴ
nigam	ㄴㅣㄱㅏㅁ
yoshimata	ㄹㅛ
spillane	ㅅㅡㅍㅣㄹㄹㅔㅇㅣㄴ
klum	ㅋㅡㄹㄹㅜㅁ
senharib	ㅅㅔㄴㅎㅏㄹㅣㅂㅡ
steuben	ㅅㅠㅌㅗㅇㅣㅂㅔㄴ
zhelezovski	ㅈㅔㄹㄹㅔㅈㅗㅂㅅㅡㅋㅣ
mechelin	ㅁㅔㅋㅔㄹㄹㅣㄴ
drinfeld	ㄷㅡㄹㅣㄴㅍㅔㄹㅌㅡ
johannsen	ㅇㅛㅎㅏㄴㅅㅔㄴ
pontecorvo	ㅍㅗㄴㅌㅔㅋㅗㄹㅡㅂㅗ
leadsom	ㄹㅔㄷㅡㅅㅓㅁ
starffin	ㅅㅡㅌㅏㄹㅜㅎㅣㄴ
turretin	ㅌㅠㄹㅔㅌㅣㄴ
wolszczan	ㅂㅗㄹㅅㅣㅊㅏㄴ
brosque	ㅂㅡㄹㅗㅅㅡㅋㅔ
mccallum	ㅁㅐㅋㅓㄹㄹㅓㅁ
coutinho	ㅋㅜㅌㅣㄴㅠ
baadsvik	ㅂㅗㄷㅡㅅㅡㅂㅣㅋㅡ
altan	ㅇㅏㄹㅌㅏㄴ
solon	ㅅㅗㄹㄹㅗㄴ
rudaki	ㄹㅜㄷㅏㅋㅣ
manish	ㅁㅏㄴㅣㅅㅣ
dreyfuss	ㄷㅡㄹㅔㅇㅣㅍㅓㅅㅡ
fellaini	ㅍㅔㄹㄹㅏㅇㅣㄴㅣ
tetrode	ㅌㅔㅌㅡㄹㅗㄷㅓ
ender	ㅇㅔㄴㄷㅓ
minamisawa	ㄴㅏㅇㅗ
torah	ㅌㅗㄹㅏ
athanasiadis	ㅇㅏㅌㅏㄴㅏㅅㅣㅇㅏㄷㅣㅅㅡ
cyrano	ㅅㅣㄹㅏㄴㅗ
sharpe	ㅅㅑㅍㅡ
lesov	ㄹㅔㅅㅗㅍㅡ
sundin	ㅅㅜㄴㄷㅣㄴ
lucilius	ㄹㅜㅋㅣㄹㄹㅣㅇㅜㅅㅡ
harutaka	ㅇㅗㄴㅗ
leanne	ㄹㅣㄴ
garity	ㄱㅐㄹㅣㅌㅣ
komnenos	ㅋㅗㅁㄴㅔㄴㅗㅅㅡ
athanasopoulos	ㅇㅏㅌㅏㄴㅏㅅㅗㅍㅜㄹㄹㅗㅅㅡ
lipponen	ㄹㅣㅍㅗㄴㅔㄴ
pawel	ㅍㅏㅂㅔㄹ
doria	ㄷㅗㄹㅣㅇㅏ
desplat	ㄷㅔㅅㅡㅍㅡㄹㄹㅏ
jambyn	ㅈㅏㅁㅂㅣㅇ
drissa	ㄷㅡㄹㅣㅅㅏ
jellicoe	ㅈㅔㄹㄹㅣㅋㅗ
pempengco	ㅍㅔㅁㅍㅣㄴㅋㅗ
bagheri	ㅂㅏㄱㅔㄹㅣ
smalls	ㅅㅡㅁㅗㄹㅅㅡ
buttigieg	ㅂㅜㅌㅣㄱㅣㄱㅡ
keng	ㅋㅔㅇ
lampson	ㄹㅐㅁㅅㅡㄴ
careca	ㅋㅏㄹㅔㅋㅏ
well	ㅇㅞㄹ
sturaro	ㅅㅡㅌㅜㄹㅏㄹㅗ
kone	ㅋㅗㄴㅔ
shuster	ㅅㅠㅅㅡㅌㅓ
fairuza	ㅍㅔㅇㅓㄹㅜㅈㅏ
madeon	ㅁㅏㄷㅔㅇㅗㅇ
mamayev	ㅁㅏㅁㅏㅇㅖㅍㅡ
songz	ㅅㅗㅇㅈㅡ
andrzejewski	ㅇㅏㄴㅈㅔㅇㅖㅍㅡㅅㅡㅋㅣ
panichwid	ㅍㅏㄴㅣㅅㅇㅟㅅ
repeta	ㄹㅔㅍㅔㅌㅏ
modiano	ㅁㅗㄷㅣㅇㅏㄴㅗ
arkwright	ㅇㅏㅋㅡㄹㅏㅇㅣㅌㅡ
margolis	ㅁㅏㄱㅗㄹㄹㅣㅅㅡ
mobon	ㅁㅗㅂㅗㄴㅇㅘㅇ
kraki	ㅋㅡㄹㅏㅋㅣ
shishigina	ㅅㅣㅅㅣㄱㅣㄴㅏ
werneck	ㅇㅞㄹㅡㄴㅔㅋㅡ
nichelle	ㄴㅣㅅㅖㄹ
ysaora	ㅇㅣㅅㅏㅇㅗㄹㅏ
lunchmoney	ㄹㅓㄴㅊㅣㅁㅓㄴㅣ
bier	ㅂㅣㅇㅔㄹㅡ
macaulay	ㅁㅐㄱㅋㅓㄹㄹㅔㅇㅣ
gerulaitis	ㅈㅔㄹㅓㄹㄹㅏㅇㅣㅌㅣㅅㅡ
farkash	ㅍㅏㄹㅡㅋㅏㅅㅣ
michels	ㅁㅣㅅㅖㅇㅜㅅㅡ
dieks	ㄷㅣㅋㅡㅅㅡ
kaos	ㅋㅏㅇㅗㅅㅡ
mckinnon	ㅁㅐㅋㅣㄴㅓㄴ
standridge	ㅅㅡㅌㅐㄴㄷㅡㄹㅣㅈㅣ
popozuda	ㅍㅗㅍㅗㅈㅜㄷㅏ
mcewan	ㅁㅐㅋㅠㅇㅓㄴ
ciani	ㅊㅣㅇㅏㄴㅣ
hanley	ㅎㅔㄴㄹㅣ
jinsol	ㅈㅣㄴㅅㅗㄹ
primakov	ㅍㅡㄹㅣㅁㅏㅋㅗㅍㅡ
abolqasem	ㅇㅏㅂㅜㄹㅋㅏㅅㅣㅁ
niluka	ㄴㅣㄹㄹㅜㅋㅏ
cheng	ㅊㅔㅇ
benussi	ㅂㅔㄴㅜㅅㅣ
lustre	ㄹㅓㅅㅡㅌㅡㄹㅔ
parygin	ㅍㅏㄹㅣㄱㅣㄴ
barnhill	ㅂㅏㄴㅎㅣㄹ
pacioli	ㅍㅏㅊㅣㅇㅗㄹㄹㅣ
miollis	ㅁㅣㅇㅗㄹㄹㅣ
emera	ㅇㅔㅁㅔㄹㅏ
nomico	ㄴㅗㅁㅣㅋㅗ
schurz	ㅅㅠㄹㅡㅊㅡ
helge	ㅎㅔㄹㄱㅔ
morgagni	ㅁㅗㄹㅡㄱㅏㄴㅣ
saritama	ㅅㅏㄹㅣㅌㅏㅁㅏ
brusilov	ㅂㅡㄹㅜㅅㅣㄹㄹㅗㅍㅡ
wedekind	ㅂㅔㄷㅔㅋㅣㄴㅌㅡ
obel	ㅇㅗㅂㅔㄹ
maio	ㅁㅏㅇㅣㅇㅗ
bonfim	ㅂㅗㄴㅍㅣㅇ
lifeson	ㄹㅏㅇㅣㅍㅡㅅㅡㄴ
sax	ㅅㅐㄱㅅㅡ
tonkel	ㅌㅗㄴㅋㅔㄹ
mendler	ㅁㅔㄴㄷㅡㄹㄹㅓ
mer	ㅁㅔㄹㅡ
stalin	ㅅㅡㅌㅏㄹㄹㅣㄴ
toba	ㅌㅗㅅㅣㅁㅏㅅㅏ
riegert	ㄹㅣㄱㅓㅌㅡ
duyn	ㄷㅏㅇㅟㄴ
dhupia	ㄷㅜㅍㅣㅇㅏ
biberstein	ㅂㅣㅂㅓㅅㅠㅌㅏㅇㅣㄴ
ireneusz	ㅇㅣㄹㅔㄴㅔㅇㅜㅅㅣ
dorando	ㄷㅗㄹㅏㄴㄷㅗ
firmino	ㅍㅣㄹㅡㅁㅣㄴㅜ
pascoli	ㅍㅏㅅㅡㅋㅗㄹㄹㅣ
ilija	ㅇㅣㄹㄹㅣㅇㅑ
borland	ㅂㅗㄹㄹㅐㄴㄷㅡ
akshay	ㅇㅏㄱㅅㅑㅇㅣ
bilardo	ㅂㅣㄹㄹㅏㄹㅡㄷㅗ
giaever	ㅇㅖㅂㅔㄹㅡ
glau	ㄱㅡㄹㄹㅏㅇㅜ
kolesov	ㅋㅗㄹㄹㅔㅅㅗㅂㅡ
vujadin	ㅂㅜㅇㅑㄷㅣㄴ
narushima	ㄹㅠ
knaan	ㅋㅔㅇㅣㄴㅏㄴ
diogenes	ㄷㅣㅇㅗㄱㅔㄴㅔㅅㅡ
magnotta	ㅁㅐㄱㅡㄴㅗㅌㅏ
westergren	ㅂㅔㅅㅡㅌㅔㄹㅡㄱㅔㄴ
huitzilihuitl	ㅇㅣㄱㅅㅡㅌㅡㄹㄹㅣㅅㅗㅊㅣㅌㅡㄹ
faraday	ㅍㅐㄹㅓㄷㅔㅇㅣ
nikopolidis	ㄴㅣㅋㅗㅍㅗㄹㄹㅣㄷㅣㅅㅡ
shibata	ㅈㅜㄴ
tremper	ㅌㅡㄹㅓㅁㅍㅓ
mahesh	ㅁㅏㅎㅔㅅㅟ
catlin	ㅋㅐㅌㅡㄹㄹㅣㄴ
dayal	ㄷㅏㅇㅑㄹ
cicarelli	ㅅㅣㅋㅏㄹㅔㄹㄹㅣ
alhassan	ㅇㅏㄹㅎㅏㅅㅅㅏㄴ
ottman	ㅇㅗㅌㅡㅁㅓㄴ
weider	ㅇㅘㅇㅣㄷㅓ
planck	ㅍㅡㄹㄹㅏㅇㅋㅡ
arafat	ㅇㅏㄹㅏㅍㅏㅌㅡ
milt	ㅁㅣㄹㅌㅓㄴ
kuprashvili	ㅋㅜㅍㅡㄹㅏㅅㅠㅂㅣㄹㄹㅣ
yoshisuke	ㅇㅛㅅㅣㅅㅡㅋㅔ
parrack	ㅍㅐㄹㅐㄱ
exner	ㅇㅔㄱㅅㅡㄴㅔㄹㅡ
caracciolo	ㅋㅏㄹㅏㅊㅗㄹㄹㅗ
kuyper	ㅋㅏㅇㅣㅍㅓ
bichir	ㅂㅣㅊㅣㄹㅡ
hrubesch	ㅎㅡㄹㅜㅂㅔㅅㅠ
bimbisara	ㅂㅣㅁㅂㅣㅅㅏㄹㅏ
aghahowa	ㅇㅏㄱㅏㅎㅗㅇㅘ
jasagtu	ㅈㅏㅅㅏㄱㅡㅌㅡ
cauchy	ㅋㅗㅅㅣ
haskil	ㅎㅏㅅㅡㅋㅣㄹ
soha	ㅅㅗㅎㅏ
katanobu	ㄱㅏㅌㅏㄴㅗㅂㅜ
zalomir	ㅈㅏㄹㄹㅗㅁㅣㄹㅡ
broughton	ㅂㅡㄹㅗㅌㅓㄴ
hardiker	ㅎㅏㄷㅣㅋㅓ
junzaburo	ㅂㅏㄴ
beernaert	ㅂㅔㄹㅡㄴㅏㄹㅡㅌㅡ
bronckhorst	ㅂㅡㄹㅗㄴㅋㅡㅎㅗㄹㅡㅅㅡㅌㅡ
francks	ㅍㅡㄹㅐㅇㅋㅡㅅㅡ
ury	ㅇㅠㄹㅣ
bernardes	ㅂㅔㄹㅡㄴㅏㄹㅡㅈㅣㅅㅡ
sharni	ㅅㅑㄴㅣ
bilen	ㅂㅣㄹㄹㅔㄴ
anka	ㅇㅐㅇㅋㅏ
brel	ㅂㅡㄹㅔㄹ
brede	ㅂㅡㄹㅔㄷㅔ
lassad	ㄹㅏㅅㅏㄷㅡ
esarhaddon	ㅇㅔㅅㅏㄹㅡㅎㅏㄷㅗㄴ
macswiney	ㅁㅐㄱㅅㅡㅇㅟㄴㅣ
vachel	ㅂㅏㅊㅔㄹ
dubinchik	ㄷㅜㅂㅣㄴㅊㅣㅋㅡ
loona	ㄹㅗㄴㅏ
esmer	ㅇㅔㅅㅡㅁㅓ
maddy	ㅁㅐㄷㅣ
bruma	ㅂㅡㄹㅜㅁㅏ
zyryanov	ㅈㅣㄹㅑㄴㅗㅍㅡ
raubal	ㄹㅏㅇㅜㅂㅏㄹ
spee	ㅅㅡㅍㅔ
arrian	ㅇㅏㄹㅣㅇㅏㄴㅗㅅㅡ
sybel	ㅈㅣㅂㅔㄹ
swardson	ㅅㅡㅇㅝㄷㅡㅅㅡㄴ
galatea	ㄱㅏㄹㄹㅏㅌㅔㅇㅏ
radiguet	ㄹㅏㄷㅣㄱㅔ
iglesia	ㅇㅣㄱㅡㄹㄹㅔㅅㅣㅇㅏ
hammar	ㅎㅏㅁㅁㅏㄹㅡ
mondale	ㅁㅓㄴㄷㅔㅇㅣㄹ
ponomaryova	ㅍㅗㄴㅗㅁㅏㄹㅛㅂㅏ
bilyaletdinov	ㅂㅣㄹㄹㅑㄹㄹㅔㅌㅡㄷㅣㄴㅗㅍㅡ
iselin	ㅇㅣㅅㅔㄹㄹㅣㄴ
nagasaka	ㅇㅠㅌㅗ
sivok	ㅅㅣㅂㅗㄱ
schnarre	ㅅㅠㄴㅏㄹㅔ
drag	ㄷㅡㄹㅐㄱㅡ
kinsuke	ㄱㅣㄴㅅㅡㅋㅔ
goulet	ㄱㅜㄹㄹㅔㅅ
etxebarria	ㅇㅔㅊㅔㅂㅔㄹㅣㅇㅏ
alcee	ㅇㅐㄹㅅㅣ
kroon	ㅋㅡㄹㅜㄴ
yasheng	ㅇㅑㅅㅖㅇ
plattenhardt	ㅍㅡㄹㄹㅏㅌㅔㄴㅎㅏㄹㅡㅌㅡ
pichler	ㅍㅣㅋㅡㄹㄹㅔㄹㅡ
vieri	ㅂㅣㅇㅔㄹㅣ
lanzoni	ㄹㅏㄴㅈㅗㄴㅣ
hochstaden	ㅎㅗㅎㅡㅅㅠㅌㅏㄷㅔㄴ
miyan	ㅁㅣㅇㅑㄴ
arnoldson	ㅇㅏㄹㅡㄴㅗㄹㄷㅡㅅㅗㄴ
papelbon	ㅍㅏㅍㅔㄹㅂㅗㄴ
srimuang	ㅅㅡㄹㅣㅁㅜㅇㅏㅇ
bialik	ㅂㅣㅇㅏㄹㅣㄱ
avola	ㅇㅏㅂㅗㄹㄹㅏ
sternbach	ㅅㅡㅌㅓㄴㅂㅏㅋㅡ
boxleitner	ㅂㅗㄱㅅㅡㄹㅏㅇㅣㅌㅡㄴㅓ
socrates	ㅅㅗㅋㅡㄹㅏㅌㅔㅅㅡ
mobraaten	ㅁㅗㅂㅡㄹㅏㅌㅔㄴ
khorobrit	ㅎㅗㄹㅗㅂㅡㄹㅣㅌㅡ
minka	ㅁㅣㄴㅋㅏ
omundson	ㅇㅗㅁㅓㄴㄷㅡㅅㅡㄴ
changmin	ㅊㅚㄱㅏㅇㅊㅏㅇㅁㅣㄴ
demetris	ㄷㅣㅁㅣㅌㅡㄹㅣㅅㅡ
cronyn	ㅋㅡㄹㅗㄴㅣㄴ
buchwald	ㅂㅜㅎㅡㅂㅏㄹㅌㅡ
carrott	ㅋㅐㄹㅓㅅ
pinnock	ㅍㅣㄴㅓㄱ
attendolo	ㅇㅏㅌㅔㄴㄷㅗㄹㄹㅗ
alferov	ㅇㅏㄹㅍㅛㄹㅗㅍㅡ
greenwell	ㄱㅡㄹㅣㄴㅇㅞㄹ
ujkani	ㅇㅜㅇㅣㅋㅏㄴㅣ
ledecky	ㄹㅓㄷㅔㅋㅣ
vitiges	ㅂㅣㅌㅣㄱㅔㅅㅡ
caviezel	ㅋㅓㅂㅣㅈㅡㄹ
chipciu	ㅋㅣㅍㅡㅊㅣㅇㅜ
alcuin	ㅇㅏㄹㅋㅟㄴ
westermarck	ㅇㅞㅅㅡㅌㅓㅁㅏㅋㅡ
steffan	ㅅㅡㅌㅔㅍㅏㄴ
jemaine	ㅈㅓㅁㅔㅇㅣㄴ
haarde	ㅎㅗㄹㅡㄷㅔ
masakore	ㅁㅏㅅㅏㅋㅗㄹㅔ
meinhardt	ㅁㅏㅇㅣㄴㅎㅏㅌㅡ
caster	ㅋㅐㅅㅡㅌㅓ
yelistratov	ㅇㅖㄹㄹㅣㅅㅡㅌㅡㄹㅏㅌㅗㅍㅡ
camoranesi	ㅋㅏㅁㅗㄹㅏㄴㅔㅅㅣ
davitian	ㄷㅔㅇㅣㅂㅣㅅㅕㄴ
evanna	ㅇㅣㅂㅏㄴㄴㅏ
odell	ㅇㅗㄷㅔㄹ
vestergaard	ㅂㅔㅅㅡㅌㅓㄱㅏㄹㅡㄷㅡ
cariba	ㅋㅏㄹㅣㅂㅏ
bessarion	ㅂㅔㅅㅏㄹㅣㅇㅗㄴ
salmon	ㅅㅐㅁㅓㄴ
holleufer	ㅎㅗㄹㄹㅔㅇㅜㅍㅔㄹㅡ
ayelet	ㅇㅏㅇㅖㄹㄹㅔㅅ
lippitt	ㄹㅣㅍㅣㅌㅡ
jakobsen	ㅇㅑㅋㅗㅂㅅㅔㄴ
djoser	ㅈㅗㅅㅔㄹㅡ
cureton	ㅋㅠㄹㅔㅌㅓㄴ
gooden	ㄱㅜㄷㅡㄴ
dif	ㄷㅣㅍㅡ
kamose	ㅋㅏㅁㅗㅅㅔ
kotipelto	ㅋㅗㅌㅣㅍㅔㄹㅌㅗ
gabry	ㄱㅏㅂㅡㄹㅣ
bakhytzhan	ㅂㅏㅋㅣㅌㅡㅈㅏㄴ
spektor	ㅅㅡㅍㅔㄱㅌㅓ
yasu	ㅇㅑㅅㅡ
abaunza	ㅇㅏㅂㅏㅇㅜㄴㅅㅏ
alexanderson	ㅇㅏㄹㄹㅔㄱㅅㅏㄴㄷㅔㄹㅡㅅㅗㄴ
jolly	ㅈㅗㄹㄹㅣ
turchynov	ㅌㅜㄹㅡㅊㅣㄴㅗㅍㅡ
halladay	ㅎㅏㄹㄹㅓㄷㅔㅇㅣ
tiffanie	ㅌㅣㅍㅓㄴㅣ
gass	ㄱㅏㅅㅡ
alesha	ㅇㅏㄹㄹㅔㅅㅑ
manea	ㅁㅏㄴㅔㅇㅏ
jamison	ㅈㅔㅁㅣㅅㅡㄴ
addys	ㅇㅐㄷㅣㅅㅡ
lucho	ㄹㅜㅊㅗ
house	ㅎㅏㅇㅜㅅㅡ
wenninger	ㅇㅞㄴㅣㅇㄱㅓ
peckham	ㅍㅔㅋㅏㅁ
blackett	ㅂㅡㄹㄹㅐㄱㅋㅔㅅ
saparmurat	ㅅㅏㅍㅏㄹㅡㅁㅜㄹㅏㅌㅡ
zeeman	ㅈㅔㅇㅣㅁㅏㄴ
svedberg	ㅅㅡㅂㅔㄷㅡㅂㅔㄹㅣ
karvelas	ㅋㅏㄹㅡㅂㅔㄹㄹㅏㅅㅡ
crissy	ㅋㅡㄹㅣㅅㅣ
tisha	ㅌㅣㅅㅑ
iturbide	ㅇㅣㅌㅜㄹㅡㅂㅣㄷㅔ
alinne	ㅇㅏㄹㄹㅣㄴㅣ
tiendalli	ㅌㅣㅇㅔㄴㄷㅏㄹㄹㅣ
vertinskaya	ㅂㅔㄹㅡㅌㅣㄴㅅㅡㅋㅏㅇㅑ
chogo	ㅊㅗㄱㅗㅇㅘㅇ
ivelin	ㅇㅣㅂㅔㄹㄹㅣㄴ
abramova	ㅇㅏㅂㅡㄹㅏㅁㅗㅂㅏ
masarim	ㅁㅏㅈㅏㄹㅣㅇ
kariokka	ㅋㅏㄹㅣㅇㅗㅋㅏ
vagit	ㅂㅏㄱㅣㅌㅡ
krige	ㅋㅡㄹㅣㄱㅓ
tibullus	ㅌㅣㅂㅜㄹㄹㅜㅅㅡ
mrvica	ㅁㅡㄹㅏㅂㅣㅊㅏ
sparrow	ㅅㅡㅍㅐㄹㅗ
ruhollah	ㄹㅜㅎㅗㄹㄹㅏ
botsman	ㅂㅗㅊㅡㅁㅓㄴ
bruford	ㅂㅡㄹㅜㅍㅓㄷㅡ
nugiseks	ㄴㅜㄱㅣㅅㅔㄱㅅㅡ
suri	ㅅㅜㄹㅣ
sokollu	ㅅㅗㅋㅗㄹㄹㅜ
augenthaler	ㅇㅏㅇㅜㄱㅔㄴㅌㅏㄹㄹㅓ
rustin	ㄹㅓㅅㅡㅌㅣㄴ
nagafusa	ㄴㅏㄱㅏㅎㅜㅅㅏ
gasset	ㄱㅏㅅㅔㅌㅡ
mestrallet	ㅁㅔㅅㅡㅌㅡㄹㅏㄹㄹㅔ
ramy	ㄹㅏㅁㅣ
kelava	ㅋㅔㄹㄹㅏㅂㅏ
talts	ㅌㅏㄹㅊㅡ
gesell	ㄱㅔㅈㅔㄹ
barrell	ㅂㅐㄹㅓㄹ
edem	ㅇㅔㄷㅏㅇ
ilincic	ㅇㅣㄹㄹㅣㄴㅊㅣㄱ
orlova	ㅇㅗㄹㄹㅗㅂㅏ
saritai	ㅅㅏㄹㄹㅣㅌㅏ
abalyan	ㅇㅏㅂㅏㄹㄹㅣㅇㅑㄴ
rudenkov	ㄹㅜㄷㅔㄴㅋㅗㅍㅡ
oktawia	ㅇㅗㄱㅌㅏㅂㅣㅇㅏ
cierpinski	ㅊㅣㄹㅡㅍㅣㄴㅅㅡㅋㅣ
nurfaizah	ㄴㅜㄹㅡㅍㅏㅇㅣㅈㅏㅎㅡ
fealy	ㅍㅣㅇㅓㄹㄹㅣ
maxie	ㅁㅐㄱㅅㅣ
pareto	ㅍㅏㄹㅔㅌㅗ
gingerich	ㅈㅣㄴㅈㅓㄹㅣㅊㅣ
minda	ㅁㅣㄴㄷㅏ
oppenhagen	ㅇㅗㅍㅔㄴㅎㅏㄱㅔㄴ
iraola	ㅇㅣㄹㅏㅇㅗㄹㄹㅏ
nolte	ㄴㅗㄹㅌㅣ
katahiro	ㄱㅏㅌㅏㅎㅣㄹㅗ
wiest	ㅇㅟㅅㅡㅌㅡ
cayden	ㅋㅔㅇㅣㄷㅡㄴ
klim	ㅋㅡㄹㄹㅣㅁ
bangs	ㅂㅐㅇㅅㅡ
simoncini	ㅅㅣㅁㅗㄴㅊㅣㄴㅣ
malokinis	ㅁㅏㄹㄹㅗㅋㅣㄴㅣㅅㅡ
broce	ㅂㅡㄹㅗㅅㅔ
churikova	ㅊㅜㄹㅣㅋㅗㅂㅏ
morrissey	ㅁㅗㄹㅣㅅㅔㅇㅣ
janette	ㅈㅏㄴㅔㅅ
chingy	ㅊㅣㅇㄱㅣ
francisley	ㅍㅡㄹㅐㄴㅅㅣㅅㅡㄹㄹㅣ
shobana	ㅅㅛㅂㅏㄴㅏ
pedroso	ㅍㅔㄷㅡㄹㅗㅅㅗ
boiardo	ㅂㅗㅇㅣㅇㅏㄹㅡㄷㅗ
skorupski	ㅅㅡㅋㅗㄹㅜㅂㅅㅡㅋㅣ
valade	ㅂㅏㄹㄹㅏㄷㅡ
ghorbanpour	ㄱㅗㄹㅡㅂㅏㄴㅍㅜㄹㅡ
kauppi	ㅋㅏㅇㅜㅍㅣ
chikanao	ㅈㅣㅋㅏㄴㅏㅇㅗ
lazaar	ㄹㅏㅈㅏㄹㅡ
malki	ㅁㅏㄹㅋㅣ
tilde	ㅌㅣㄹㄷㅔ
gondosubroto	ㄱㅗㄴㄷㅗㅅㅜㅂㅡㄹㅗㅌㅗ
stacchiotti	ㅅㅡㅌㅏㅊㅣㅇㅗㅌㅣ
warwick	ㅇㅝㄹㅣㄱ
alshammar	ㅇㅏㄹㅅㅡㅎㅏㅁㅁㅏㄹㅡ
ignez	ㅇㅣㄱㅡㄴㅔㅅㅡ
kiesbauer	ㅋㅣㅅㅡㅂㅏㅇㅜㅇㅓ
karter	ㅋㅏㅌㅓ
vice	ㅂㅏㅇㅣㅅㅡ
dwyer	ㄷㅡㅇㅘㅇㅣㅇㅓ
vrhovnik	ㅂㅡㄹㅡㅎㅗㅂㅡㄴㅣㅋㅡ
enokids	ㅇㅔㄴㅗㅋㅣㅈㅡ
fuca	ㅍㅜㅋㅏ
novoselov	ㄴㅗㅂㅗㅅㅔㄹㄹㅗㅍㅡ
poston	ㅍㅗㅅㅡㅌㅓㄴ
ceulemans	ㅋㅚㄹㄹㅔㅁㅏㄴㅅㅡ
kricfalusi	ㅋㅡㄹㅣㅅㅡㅍㅓㄹㄹㅜㅅㅣ
sansa	ㅅㅏㄴㅅㅏ
caggiano	ㅋㅏㅈㅣㅇㅏㄴㅗ
chianese	ㅋㅣㅇㅓㄴㅔㅅㅔ
kolesnikov	ㅋㅗㄹㄹㅔㅅㅡㄴㅣㅋㅗㅍㅡ
andreja	ㅇㅏㄴㄷㅡㄹㅔㅇㅣ
rippon	ㄹㅣㅍㅓㄴ
teagarden	ㅌㅣㄱㅏㄷㅡㄴ
kerrie	ㅋㅔㄹㅣ
andie	ㅇㅐㄴㄷㅣ
arno	ㅇㅏㄹㅡㄴㅗ
cantinflas	ㅋㅏㄴㅌㅣㄴㅍㅡㄹㄹㅏㅅㅡ
crombez	ㅋㅡㄹㅗㅁㅂㅔ
trudgill	ㅌㅡㄹㅜㅈㅣㄹ
lomana	ㄹㅗㅁㅏㄴㅏ
askola	ㅇㅏㅅㅡㅋㅗㄹㄹㅏ
arrington	ㅇㅐㄹㅣㅇㅌㅓㄴ
fassbinder	ㅍㅏㅅㅡㅂㅣㄴㄷㅓ
nestsiarenka	ㄴㅔㅅㅡㅊㅏㄹㅔㄴㅋㅏ
guardiola	ㄱㅘㄹㅡㄷㅣㅇㅗㄹㄹㅏ
langella	ㄹㅏㄴㅈㅔㄹㄹㅏ
dijana	ㄷㅣㅇㅑㄴㅏ
aimoto	ㅇㅠㅋㅏ
suran	ㅅㅜㄹㅏㄴ
barzani	ㅂㅏㄹㅡㅈㅏㄴㅣ
mechlowicz	ㅁㅣㅋㅡㄹㄹㅗㅂㅣㅊㅣ
robinho	ㅎㅗㅂㅣㄴㅠ
benkei	ㅂㅔㄴㅋㅔㅇㅣ
schwartzberg	ㅅㅠㅇㅘㄹㅊㅡㅂㅓㄱㅡ
dcruz	ㄷㅣㅋㅡㄹㅜㅈㅡ
chulpan	ㅊㅜㄹㅍㅏㄴ
aljo	ㅇㅏㄹㅎㅗ
heynckes	ㅎㅏㅇㅣㄴㅋㅔㅅㅡ
reyez	ㄹㅔㅇㅖㅅㅡ
blatter	ㅂㅡㄹㄹㅏㅌㅓ
datis	ㄷㅏㅌㅣㅅㅡ
meyde	ㅁㅔㅇㅣㄷㅓ
monasterio	ㅁㅗㄴㅏㅅㅡㅌㅔㄹㅣㅇㅗ
jenneke	ㅈㅔㄴㅔㅋㅓ
koblin	ㅋㅗㅂㅡㄹㄹㅣㄴ
sourpis	ㅅㅜㄹㅡㅍㅣㅅㅡ
bisbal	ㅂㅣㅅㅡㅂㅏㄹ
sarfate	ㅅㅏㅍㅏㅌㅔ
munson	ㅁㅓㄴㅅㅡㄴ
goemon	ㄱㅗㅇㅔㅁㅗㄴ
scholem	ㅅㅛㄹㄹㅔㅁ
nabonidus	ㄴㅏㅂㅗㄴㅣㄷㅜㅅㅡ
skouris	ㅅㅡㅋㅜㄹㅣㅅㅡ
lata	ㄹㅏㅌㅏ
bernanos	ㅂㅔㄹㅡㄴㅏㄴㅗㅅㅡ
boulmerka	ㅂㅜㄹㅁㅔㄹㅡㅋㅏ
sanctis	ㅅㅏㄴㅊㅣㅅㅡ
nordqvist	ㄴㅗㄹㅡㄷㅡㅋㅡㅂㅣㅅㅡㅌㅡ
merrygold	ㅁㅔㄹㅣㄱㅗㄹㄷㅡ
etrit	ㅇㅔㅌㅡㄹㅣㅌㅡ
backwell	ㅂㅐㄱㅇㅞㄹ
vaguinho	ㅂㅏㄱㅣㄴㅠ
faras	ㅍㅏㄹㅏㅅㅡ
scharnhorst	ㅅㅑㄹㅡㄴㅎㅗㄹㅡㅅㅡㅌㅡ
bierce	ㅂㅣㅇㅓㅅㅡ
richa	ㄹㅣㅊㅏ
goedgedrag	ㅎㅜㅎㅓㄷㅡㄹㅏㅎㅡ
thekla	ㅌㅔㅋㅡㄹㄹㅏ
samaranch	ㅅㅏㅁㅏㄹㅏㄴㅊㅣ
vaz	ㅂㅏㅈㅡ
angilbert	ㅇㅏㄴㄱㅣㄹㅂㅔㄹㅡㅌㅡ
akebono	ㅇㅏㅋㅔㅂㅗㄴㅗ
hosiner	ㅎㅜㅈㅣㄴㄴㅏ
uhuru	ㅇㅜㅎㅜㄹㅜ
makrembolitissa	ㅁㅏㅋㅡㄹㅔㄴㅂㅗㄹㅣㅌㅣㅅㅏ
holgate	ㅎㅗㄹㄱㅔㅇㅣㅌㅡ
arefkia	ㅇㅏㄹㅔㅍㅡㅋㅣㅇㅏ
vhong	ㅂㅗㅇ
toshitomo	ㄷㅗㅅㅣㅌㅗㅁㅗ
amirah	ㅇㅏㅁㅣㄹㅏ
cray	ㅋㅡㄹㅔㅇㅣ
imke	ㅇㅣㅁㅋㅔ
bada	ㅂㅏㄷㅏ
kiani	ㅋㅣㅇㅏㄴㅣ
izotov	ㅇㅣㅈㅗㅌㅗㅍㅡ
papadimitriou	ㅍㅏㅍㅏㄷㅣㅁㅣㅌㅡㄹㅣㅇㅜ
finneran	ㅍㅣㄴㅓㄹㅏㄴ
havas	ㅎㅏㅂㅏㅅㅡ
lieberknecht	ㄹㅣㅂㅔㄹㅡㅋㅡㄴㅔㅎㅣㅌㅡ
riebeeck	ㄹㅣㅂㅔㅋㅡ
lysacek	ㄹㅏㅇㅣㅅㅓㅊㅔㄱ
fiorina	ㅍㅣㅇㅗㄹㅣㄴㅏ
berthollet	ㅂㅔㄹㅡㅌㅗㄹㄹㅔ
gatiss	ㄱㅔㅇㅣㅌㅣㅅㅡ
nagi	ㅇㅑㄴㅏㄱㅣ
sukjong	ㅅㅜㄱㅈㅗㅇ
naohide	ㄴㅏㅇㅗㅎㅣㄷㅔ
mashkov	ㅁㅏㅅㅣㅋㅗㅍㅡ
branting	ㅂㅡㄹㅏㄴㅌㅣㅇ
nawaf	ㄴㅏㅇㅘㅍㅡ
bacchi	ㅂㅏㅅㅣ
karadeniz	ㅋㅏㄹㅏㄷㅔㄴㅣㅈㅡ
foucan	ㅍㅜㅋㅏㅇ
strassburg	ㅅㅠㅌㅡㄹㅏㅅㅡㅂㅜㄹㅡㅋㅡ
sancroft	ㅅㅐㄴㅋㅡㄹㅗㅍㅡㅌㅡ
coupe	ㅋㅜㅍㅡ
bony	ㅂㅗㄴㅣ
brooklyn	ㅂㅡㄹㅜㅋㅡㄹㄹㅣㄴ
nobumasu	ㄴㅗㅂㅜㅁㅏㅅㅡ
steinhaus	ㅅㅡㅌㅔㅇㅣㄴㅎㅏㅇㅜㅅㅡ
ubukata	ㅌㅗㅇㅜ
achilles	ㅇㅏㅋㅣㄹㄹㅔㅅㅡ
kinberg	ㅋㅣㄴㅂㅓㄱㅡ
grimaldi	ㄱㅡㄹㅣㅁㅏㄹㄷㅣ
yegorov	ㅇㅖㄱㅗㄹㅗㅍㅡ
mantantu	ㅁㅏㄴㅌㅏㄴㅌㅜ
panagoulias	ㅍㅏㄴㅏㄱㅜㄹㄹㅣㅇㅏㅅㅡ
raja	ㄹㅏㅈㅏ
masopust	ㅁㅏㅅㅗㅍㅜㅅㅡㅌㅡ
sampaoli	ㅅㅏㅁㅍㅏㅇㅗㄹㄹㅣ
corby	ㅋㅗㅂㅣ
shalamov	ㅅㅑㄹㄹㅏㅁㅗㅍㅡ
perec	ㅍㅔㄹㅔㄱ
nobutami	ㄴㅗㅂㅜㅌㅏㅁㅣ
liberato	ㄹㅣㅂㅓㄹㅏㅌㅗ
satyarthi	ㅅㅏㅌㅣㅇㅏㄹㅡㅌㅣ
tzavellas	ㅊㅏㅂㅔㄹㄹㅏㅅㅡ
million	ㅁㅣㄹㄹㅣㅇㅓㄴ
chkalov	ㅊㅣㅋㅏㄹㄹㅗㅍㅡ
rez	ㄹㅔㅈㅡ
matsukata	ㅁㅏㅆㅡㅋㅏㅌㅏ
leinart	ㄹㅏㅇㅣㄴㅏㅌㅡ
madureira	ㅁㅐㄷㅓㄹㅔㅇㅓㄹㅏ
manilow	ㅁㅐㄴㅣㄹㄹㅗ
tariverdiev	ㅌㅏㄹㅣㅂㅔㄹㅡㄷㅣㅇㅖㅍㅡ
lucia	ㄹㅜㅊㅣㅇㅏ
yzerman	ㅇㅏㅇㅣㅈㅓㅁㅓㄴ
denarnaud	ㄷㅡㄴㅏㄹㅡㄴㅗ
jurickson	ㅈㅜㄹㅣㄱㅅㅡㄴ
uzeyir	ㅇㅜㅈㅔㅇㅣㄹㅡ
striesow	ㅅㅠㅌㅡㄹㅣㅈㅗ
smyrnaeus	ㅅㅡㅁㅣㄹㅡㄴㅏㅇㅣㅇㅗㅅㅡ
syahputra	ㅅㅑㅍㅜㅌㅡㄹㅏ
whistler	ㅎㅟㅅㅡㄹㄹㅓ
milland	ㅁㅣㄹㄹㅐㄴㄷㅡ
durmaz	ㄷㅜㄹㅡㅁㅏㅈㅡ
critias	ㅋㅡㄹㅣㅌㅣㅇㅏㅅㅡ
casarini	ㅋㅏㅅㅏㄹㅣㄴㅣ
helbig	ㅎㅔㄹㅂㅣㅎㅣ
gilley	ㄱㅣㄹㄹㅣ
sonkham	ㅅㅗㄴㅋㅏㅁ
eremenko	ㅇㅔㄹㅔㅁㅔㄴㅋㅗ
nagarjuna	ㅇㅛㅇㅅㅜ
dami	ㄷㅏㅁㅣ
shaushtatar	ㅅㅏㅇㅜㅅㅠㅌㅏㅌㅏㄹㅡ
bedimo	ㅂㅔㄷㅣㅁㅗ
karlie	ㅋㅏㄹㄹㅣ
katharina	ㅋㅏㅌㅏㄹㅣㄴㅏ
jano	ㅈㅏㄴㅗ
rajah	ㄹㅏㅈㅏ
sadaharu	ㅇㅗ
zagorcheva	ㅈㅏㄱㅗㄹㅡㅊㅔㅂㅏ
breslow	ㅂㅡㄹㅔㅅㅗㄹㄹㅗㅇㅜ
chicherova	ㅊㅣㅊㅔㄹㅗㅂㅏ
grossman	ㄱㅡㄹㅗㅅㅡㅁㅓㄴ
additon	ㅇㅔㄷㅣㅌㅡㄴ
pritlove	ㅍㅡㄹㅣㅌㅡㄹㅗㅂㅡ
offenbach	ㅇㅗㅍㅔㄴㅂㅏㅎㅡ
nazimuddin	ㄴㅏㅈㅣㅁㅜㄷㅣㄴ
mirzoyan	ㅁㅣㄹㅡㅈㅗㅇㅑㄴ
suheir	ㅅㅜㅎㅔㅇㅣㄹㅡ
ibi	ㅇㅣㅂㅣ
andrejs	ㅇㅏㄴㄷㅡㄹㅔㅇㅣㅅㅡ
tamina	ㅌㅏㅁㅣㄴㅏ
weichselbraun	ㅂㅏㅇㅣㅋㅡㅅㅔㄹㅂㅡㄹㅏㅇㅜㄴ
tanenaga	ㄷㅏㄴㅔㄴㅏㄱㅏ
railsback	ㄹㅔㅇㅣㄹㅈㅡㅂㅐㄱ
bertolacci	ㅂㅔㄹㅡㅌㅗㄹㄹㅏㅊㅣ
akatyev	ㅇㅏㅋㅏㅌㅣㅇㅖㅍㅡ
delay	ㄷㅣㄹㄹㅔㅇㅣ
wolinski	ㅂㅗㄹㄹㅣㄴㅅㅡㅋㅣ
veljohnson	ㅂㅔㄹㅈㅗㄴㅅㅡㄴ
bachelet	ㅂㅏㅅㅠㄹㄹㅔ
hausdorff	ㅎㅏㅇㅜㅅㅡㄷㅗㄹㅡㅍㅡ
rahnama	ㄹㅏㄴㅏㅁㅏ
duterte	ㄷㅜㅌㅔㄹㅡㅌㅔ
mirzakhani	ㅁㅣㄹㅡㅈㅏㅋㅏㄴㅣ
kocharyan	ㅋㅗㅊㅏㄹㅣㅇㅑㄴ
mcgoohan	ㅁㅐㄱㄱㅜㅇㅓㄴ
olbrich	ㅇㅗㄹㅂㅡㄹㅣㅎㅣ
bordet	ㅂㅗㄹㅡㄷㅔ
ruzzini	ㄹㅜㅊㅣㄴㅣ
jollien	ㅈㅗㄹㄹㅣㅇㅏㅇ
baptist	ㅂㅏㅂㅌㅣㅅㅡㅌㅏ
edelhagen	ㅇㅔㄷㅔㄹㅎㅏㄱㅔㄴ
qasem	ㅋㅏㅈㅔㅁ
aburizal	ㅇㅏㅂㅜㄹㅣㅈㅏㄹ
hermite	ㅇㅔㄹㅡㅁㅣㅌㅡ
locsin	ㄹㅗㄱㅅㅣㄴ
masuzo	ㅁㅏㄷㅗㄴㅗ
paletta	ㅍㅏㄹㄹㅔㅌㅏ
drescher	ㄷㅡㄹㅔㅅㅕ
kimarcus	ㅋㅣㅁㅏㄹㅡㅋㅜㅅㅡ
castellini	ㅋㅏㅅㅡㅌㅔㄹㄹㅣㄴㅣ
foxworth	ㅍㅗㄱㅅㅡㅇㅝㅅㅡ
kostetskaya	ㅋㅗㅅㅡㅌㅔㅅㅡㅋㅏㅇㅑ
puttnam	ㅍㅓㅅㄴㅏㅁ
bingley	ㅂㅣㅇㄱㅡㄹㄹㅣ
bunyan	ㅂㅓㄴㅣㅇㅓㄴ
kongolo	ㅋㅗㅇㅇㅗㄹㄹㅗ
cvitanich	ㅋㅡㅂㅣㅌㅏㄴㅣㅊㅣ
takami	ㅇㅏㅋㅏㅇㅣ
arsenio	ㅇㅏㄹㅡㅅㅔㄴㅣㅇㅗ
striker	ㅅㅡㅌㅡㄹㅏㅇㅣㅋㅓ
relander	ㄹㅔㄹㄹㅏㄴㄷㅔㄹㅡ
bazelli	ㅂㅏㅈㅔㄹㄹㅣ
edgley	ㅇㅔㅈㅡㄹㄹㅣ
phumisak	ㅍㅜㅁㅣㅅㅏㄱ
adjani	ㅇㅏㅈㅏㄴㅣ
darrieux	ㄷㅏㄹㅣㅇㅠ
buschschulte	ㅂㅜㅅㅠㅅㅠㄹㅌㅔ
seitz	ㅅㅏㅇㅣㅊㅡ
chevrolet	ㅅㅖㅂㅡㄹㅓㄹㄹㅔㅇㅣ
raynald	ㄹㅡㄴㅗ
nicklaus	ㄴㅣㅋㅡㄹㄹㅏㅇㅜㅅㅡ
fortounis	ㅍㅗㄹㅡㅌㅜㄴㅣㅅㅡ
telipinu	ㅌㅔㄹㄹㅔㅍㅣㄴㅜ
mulisch	ㅁㅟㄹㄹㅣㅅㅡ
eretto	ㅇㅔㄹㅔㅅㅌㅗ
ahern	ㅇㅏㅎㅓㄴ
ermonela	ㅇㅔㄹㅡㅁㅗㄴㅔㄹㄹㅏ
kovalyov	ㅋㅗㅂㅏㄹㄹㅛㅍㅡ
ikeido	ㅈㅜㄴ
rubidge	ㄹㅜㅂㅣㅈㅣ
fabiola	ㅍㅏㅂㅣㅇㅗㄹㄹㅏ
vinci	ㅂㅣㄴㅅㅣ
nosrati	ㄴㅗㅅㅡㄹㅏㅌㅣ
dobromir	ㄷㅗㅂㅡㄹㅗㅁㅣㄹㅡ
zemgals	ㅈㅔㅁㄱㅏㄹㅅㅡ
hajjar	ㅎㅏㅈㅏㄹㅡ
baruj	ㅂㅏㄹㅜ
biasi	ㅂㅣㅇㅏㅅㅣ
kleveland	ㅋㅡㄹㄹㅔㅂㅔㄹㄹㅏㄴ
garshin	ㄱㅏㄹㅡㅅㅣㄴ
liverpool	ㄹㅣㅂㅓㅍㅜㄹ
detten	ㄷㅔㅌㅡㄴ
adem	ㅇㅏㄷㅔㅁ
sandino	ㅅㅏㄴㄷㅣㄴㅗ
stefansson	ㅅㅡㅌㅔㅍㅏㅇㅜㄴㅅㅗㄴ
feindouno	ㅍㅐㅇㄷㅜㄴㅗ
spitz	ㅅㅡㅍㅣㅊㅡ
kazinsky	ㅋㅏㅈㅣㄴㅅㅡㅋㅣ
korchnoi	ㅋㅗㄹㅡㅊㅣㄴㅗㅇㅣ
wheldon	ㅇㅞㄹㄷㅓㄴ
spurrier	ㅅㅡㅍㅓㄹㅣㅇㅓ
mihhailova	ㅁㅣㅎㅏㅇㅣㄹㄹㅗㅂㅏ
zubkov	ㅈㅜㅂㅋㅗㅍㅡ
nakazato	ㄱㅗㅈㅣ
shunji	ㅅㅠㄴㅈㅣ
knubel	ㅋㅜㄴㅂㅔㄹ
chelimo	ㅊㅔㄹㄹㅣㅁㅗ
quimby	ㅋㅟㅁㅂㅣ
royster	ㄹㅗㅇㅣㅅㅡㅌㅓ
stadnyk	ㅅㅡㅌㅏㄷㅡㄴㅣㅋㅡ
lafargue	ㄹㅏㅍㅏㄹㅡㄱㅡ
argota	ㅇㅏㄱㅗㅌㅏ
cayce	ㅋㅔㅇㅣㅅㅣ
merrell	ㅁㅔㄹㅔㄹ
hassabis	ㅎㅓㅅㅏㅂㅣㅅㅡ
desargues	ㄷㅔㅈㅏㄹㅡㄱㅡ
lahaye	ㄹㅏㅎㅔㅇㅣ
nalick	ㄴㅏㄹㄹㅣㄱ
teymourian	ㅌㅔㅇㅣㅁㅜㄹㅣㅇㅏㄴ
kemkaran	ㅋㅔㅁㅋㅏㄹㅏㄴ
dunstaple	ㄷㅓㄴㅅㅡㅌㅓㅂㅡㄹ
pedroia	ㅍㅔㄷㅡㄹㅗㅇㅣㅇㅏ
fabra	ㅍㅏㅂㅡㄹㅏ
kazenga	ㅋㅏㅈㅔㅇㄱㅏ
moen	ㅁㅗㅇㅔㄴ
nabopolassar	ㄴㅏㅂㅗㅍㅗㄹㄹㅏㅅㅏㄹㅡ
alisar	ㅇㅏㄹㄹㅣㅅㅏㄹㅡ
dreifort	ㄷㅡㄹㅏㅇㅣㅍㅗㅌㅡ
skoog	ㅅㅡㅋㅗㄱㅡ
drury	ㄷㅡㄹㅓㄹㅣ
hirst	ㅎㅓㅅㅡㅌㅡ
weissmuller	ㅇㅘㅇㅣㅈㅡㅁㅠㄹㄹㅓ
lodbrok	ㄹㅗㄷㅡㅂㅡㄹㅗㅋㅡ
ilonzeh	ㅇㅣㄹㅗㄴㅈㅔ
shepseskaf	ㅅㅖㅂㅅㅔㅅㅡㅋㅏㅍㅡ
siobhan	ㅅㅣㅇㅗㅂㅏㄴ
lorenzen	ㄹㅗㄹㅔㄴㅈㅔㄴ
gossard	ㄱㅗㅅㅏㄷㅡ
minaguchi	ㅇㅠㅋㅗ
fillmore	ㅍㅣㄹㅁㅗㅇㅓ
robberts	ㄹㅗㅂㅓㅊㅡ
sukenori	ㅅㅡㅋㅔㄴㅗㄹㅣ
stritch	ㅅㅡㅌㅡㄹㅣㅊㅣ
caicedo	ㅋㅏㅇㅣㅅㅔㄷㅗ
seitaridis	ㅅㅔㅇㅣㅌㅏㄹㅣㄷㅣㅅㅡ
yennaris	ㅇㅖㄴㅏㄹㅣㅅㅡ
evatt	ㅇㅔㅂㅓㅌㅡ
parrino	ㅍㅐㄹㅣㄴㅗ
bargh	ㅂㅏㄱㅡ
bonny	ㅂㅗㄴㅣ
galileo	ㄱㅏㄹㄹㅣㄹㄹㅔㅇㅗ
bancilhon	ㅂㅏㅇㅅㅣㄹㄹㅗㅇ
pujalte	ㅍㅜㅎㅏㄹㅌㅔ
alija	ㅇㅏㄹㄹㅣㅇㅑ
dinklage	ㄷㅣㅇㅋㅡㄹㄹㅔㅇㅣㅈㅣ
raymund	ㄹㅔㅇㅣㅁㅓㄴㄷㅡ
lopetegui	ㄹㅗㅍㅔㅌㅔㄱㅣ
erykah	ㅇㅔㄹㅣㅋㅏ
chokri	ㅅㅠㅋㅡㄹㅣ
beverly	ㅂㅣㅂㅓㄹㅣ
kemy	ㅋㅔㅁㅣ
hurewicz	ㅎㅜㄹㅔㅂㅣㅊㅣ
gonsalves	ㄱㅗㄴㅅㅏㄹㅂㅔㅅㅡ
stenka	ㅅㅡㅌㅔㄴㅋㅏ
ujah	ㅇㅜㅈㅏ
ankhesenamun	ㅇㅏㄴㅋㅔㅅㅔㄴㅏㅁㅔㄴ
basargin	ㅂㅏㅅㅏㄹㅡㄱㅣㄴ
valdes	ㅂㅏㄹㄷㅔㅅㅡ
scoot	ㅅㅡㅋㅜㅌㅡ
blok	ㅂㅡㄹㄹㅗㄱ
feyerabend	ㅍㅏㅇㅣㅇㅓㅇㅏㅂㅔㄴㅌㅡ
haysbert	ㅎㅔㅇㅣㅅㅡㅂㅓㅌㅡ
moneta	ㅁㅗㄴㅔㅌㅏ
agassa	ㅇㅏㄱㅏㅅㅏ
moellendorff	ㅁㅚㄹㄹㅔㄴㄷㅗㄹㅡㅍㅡ
bassols	ㅂㅏㅅㅗㄹㅅㅡ
noda	ㄴㅗㄷㅏ
borbon	ㅂㅗㅂㅗㄴ
arsens	ㅇㅏㄹㅡㅅㅔㄴㅅㅡ
mamedyarov	ㅁㅔㅁㅁㅔㄷㅣㅇㅏㄹㅗㅍㅡ
mikulski	ㅁㅣㅋㅓㄹㅅㅡㅋㅣ
emomali	ㅇㅔㅁㅗㅁㅏㄹㄹㅣ
baiba	ㅂㅏㅇㅣㅂㅏ
martindale	ㅁㅏㅌㅣㄴㄷㅔㅇㅣㄹ
ridgewell	ㄹㅣㅈㅣㅇㅞㄹ
chungsuk	ㅊㅜㅇㅅㅜㄱㅇㅘㅇ
cabase	ㅋㅏㅂㅏㅅㅔ
mauresmo	ㅁㅗㄹㅔㅅㅡㅁㅗ
lodeweges	ㄹㅗㄷㅡㅇㅞㅈㅣㅅㅡ
ifeanyi	ㅇㅣㅍㅔㅇㅏㄴㅣ
tokihisa	ㅅㅛㄱㅗ
beuys	ㅂㅗㅇㅣㅅㅡ
rendla	ㄹㅔㄴㄷㅡㄹㅏ
gabulov	ㄱㅏㅂㅜㄹㄹㅗㅍㅡ
sawayama	ㄹㅣㄴㅏ
morganella	ㅁㅗㄹㅡㄱㅏㄴㅔㄹㄹㅏ
ignjovski	ㅇㅣㄱㅡㄴㅛㅂㅡㅅㅡㅋㅣ
febiger	ㅍㅔㅂㅣㄱㅓ
shlomit	ㅅㅣㄹㄹㅗㅁㅣㅌㅡ
bagdasarov	ㅂㅏㄱㅡㄷㅏㅅㅏㄹㅗㅍㅡ
colani	ㄲㅗㄹㄹㅏㄴㅣ
cornett	ㅋㅗㄴㅔㅅ
jaysuma	ㅈㅏㅇㅣㅅㅜㅁㅏ
limbach	ㄹㅣㅁㅂㅏㅎㅡ
morricone	ㅁㅗㄹㅣㅋㅗㄴㅔ
naoshige	ㄴㅏㅇㅗㅅㅣㄱㅔ
harzer	ㅎㅏㄹㅡㅊㅓ
gansky	ㄱㅐㄴㅅㅡㅋㅣ
tinkara	ㅌㅣㄴㅋㅏㄹㅏ
cois	ㅋㅗㅇㅣㅅㅡ
murnau	ㅁㅜㄹㅡㄴㅏㅇㅜ
myriam	ㅁㅣㄹㅣㅇㅏㅁ
emeraude	ㅇㅔㅁㅔㄹㅏㅇㅜㄷㅔ
ludendorff	ㄹㅜㄷㅔㄴㄷㅗㄹㅡㅍㅡ
radnashiri	ㄹㅏㄷㅡㄴㅏㅅㅣㄹㅣ
sanches	ㅅㅏㄴㅊㅔㅅㅡ
azza	ㅇㅏㅈㅏ
nimeiry	ㄴㅣㅁㅔㅇㅣㄹㅣ
feza	ㅍㅔㅈㅏ
singeom	ㅅㅣㄴㄱㅓㅁ
burks	ㅂㅓㄱㅅㅡ
rivette	ㄹㅣㅂㅔㅌㅡ
anoushka	ㅇㅏㄴㅜㅅㅠㅋㅏ
verstovsky	ㅂㅔㄹㅡㅅㅡㅌㅗㅍㅡㅅㅡㅋㅣ
cael	ㅋㅔㅇㅣㄹ
pernambucano	ㅍㅔㄹㅡㄴㅏㅁㅂㅜㅋㅏㄴㅜ
prodi	ㅍㅡㄹㅗㄷㅣ
chahine	ㅅㅑㅎㅣㄴ
janey	ㅈㅔㅇㅣㄴㅣ
yennie	ㅇㅖㄴㅣ
dinerchtein	ㄷㅣㄴㅓㅅㅡㅌㅏㅇㅣㄴ
yao	ㅇㅑㅇㅗ
raslanas	ㄹㅏㅅㅡㄹㄹㅏㄴㅏㅅㅡ
bakrie	ㅂㅏㅋㅡㄹㅣㅇㅔ
gedevanishvili	ㄱㅔㄷㅔㅂㅏㄴㅣㅅㅠㅂㅣㄹㄹㅣ
picado	ㅍㅣㅋㅏㄷㅗ
faustus	ㅍㅏㅇㅜㅅㅡㅌㅜㅅㅡ
tchoumitcheva	ㅊㅜㅁㅣㅊㅔㅂㅏ
munemitsu	ㅁㅜㄴㅔㅁㅣㅆㅡ
weerasethakul	ㅇㅟㄹㅏㅅㅔㅌㅏㅋㅜㄴ
kaip	ㅋㅏㅇㅣㅍㅡ
juhi	ㅈㅜㅎㅣ
walsman	ㅇㅝㄹㅅㅡㅁㅓㄴ
bruus	ㅂㅡㄹㅜㅅㅡ
ramona	ㄹㅝㅁㅗㄴㅏ
azahara	ㅇㅏㅅㅏㅇㅏㄹㅏ
iniesta	ㅇㅣㄴㅣㅇㅔㅅㅡㅌㅏ
kropotkin	ㅋㅡㄹㅗㅍㅗㅌㅡㅋㅣㄴ
kandinski	ㅋㅏㄴㄷㅣㄴㅅㅡㅋㅣ
felton	ㅍㅔㄹㅌㅓㄴ
ratas	ㄹㅏㅌㅏㅅㅡ
ottl	ㅇㅗㅌㅡㄹ
maddox	ㅁㅐㄷㅗㄱㅅㅡ
sekihara	ㄹㅛㄱㅏ
stoker	ㅅㅡㅌㅗㅋㅓ
kipketer	ㅋㅣㅂㅋㅔㅌㅓ
frangiskos	ㅍㅡㄹㅏㄴㄱㅣㅅㅡㅋㅗㅅㅡ
vassiljev	ㅂㅏㅅㅣㄹㄹㅣㅇㅖㅍㅡ
kokubo	ㅈㅠㄴ
monro	ㅁㅓㄴㄹㅗ
amenohiboko	ㅇㅏㅁㅔㄴㅗㅎㅣㅂㅗㅋㅗ
umm	ㅇㅜㅁ
seacrest	ㅅㅣㅋㅡㄹㅔㅅㅡㅌㅡ
meyerhold	ㅁㅔㅇㅣㅇㅔㄹㅡㅎㅗㄹㄹㅣㄷㅡ
seigenthaler	ㅅㅔㅇㅣㄱㅔㄴㅌㅏㄹㄹㅓ
baines	ㅂㅔㅇㅣㄴㅅㅡ
mantzius	ㅁㅏㄴㅊㅣㅇㅜㅅㅡ
zinta	ㅈㅣㄴㅌㅏ
kinsey	ㅋㅣㄴㅈㅔㅇㅣ
gustavsson	ㄱㅜㅅㅡㅌㅏㅍㅡㅅㅗㄴ
pelosi	ㅍㅔㄹㄹㅗㅅㅣ
papalia	ㅍㅐㅍㅓㄹㄹㅣㅇㅏ
georgiana	ㅈㅗㅈㅣㅇㅏㄴㅏ
martella	ㅁㅏㄹㅡㅌㅔㄹㄹㅏ
sadatoshi	ㅅㅏㄷㅏㅌㅗㅅㅣ
krayzie	ㅋㅡㄹㅔㅇㅣㅈㅣ
joensen	ㅇㅖㄴㅅㅔㄴ
zickler	ㅊㅣㅋㅡㄹㄹㅓ
tommie	ㅌㅗㅁㅣ
drameh	ㄷㅡㄹㅓㅁㅔㅇㅣ
nagatoki	ㄴㅏㄱㅏㅌㅗㅋㅣ
flavor	ㅍㅡㄹㄹㅔㅇㅣㅂㅓ
yibo	ㅇㅣㅂㅐㄱ
shamo	ㅅㅑㅁㅗ
krankl	ㅋㅡㄹㅏㅇㅋㅡㄹ
merafhe	ㅁㅔㄹㅏㅍㅔ
irone	ㅇㅏㅇㅣㅇㅓㄴ
kok	ㅋㅗㅋㅡ
taslima	ㅌㅏㅅㅡㄹㄹㅣㅁㅏ
geguri	ㄱㅔㄱㅜㄹㅣ
veldhuis	ㅍㅔㄹㅌㅡㅎㅟㅅㅡ
fridolin	ㅍㅡㄹㅣㄷㅗㄹㄹㅣㄴ
habsburg	ㅇㅗㅌㅗ
hartmanis	ㅎㅏㄹㅡㅌㅡㅁㅏㄴㅣㅅㅡ
asen	ㅇㅏㅅㅔㄴ
deklin	ㄷㅔㅋㅡㄹㄹㅣㄴ
rostand	ㄹㅗㅅㅡㅌㅏㅇ
sayasone	ㅅㅏㅇㅑㅅㅗㄴ
cremona	ㅋㅡㄹㅔㅁㅗㄴㅏ
galleani	ㄱㅏㄹㄹㅔㅇㅏㄴㅣ
dilthey	ㄷㅣㄹㅌㅏㅇㅣ
